a$$  -   ass
a&f  -   always and forever
a'ight  -   alright
a/l  -   age and location
a/m  -   away message
a/s/l  -   age,sex,location
a/s/l/p  -   age/sex/location/picture
a/s/l/r  -   age, sex, location, race
a1t  -   anyone there
abft  -   about fucking time
aboot  -   about
abreev  -   abbreviation
absnt  -   absent
abt  -   about
abwt  -   about
acct  -   account
acgaf  -   absolutely couldn't give a fuck
ack  -   acknowledged
afaic  -   as far as I'm concerned
afaicr  -   As Far As I Can Remember
afaics  -   as far as I can see
afaict  -   as far as I can tell
afaik  -   as far as I know
afair  -   as far as I recall
afaiu  -   As far as I understand
afcpmgo  -   away from computer parents may go on
afkb  -   away from keyboard
agn  -   again
ahole  -   asshole
a-hole  -  asshole
aight  -   alright
aightz  -   alright
aiic  -   as if I care
aiid  -   and if I did
aiight  -   all right
aint   -  ain't
aite  -   alright
alot  -   a lot
alrite  -   alright
alrt  -   alright
alryt  -   alright
amiic  -   ask me if i care
amiigaf  -   ask me if i give a fuck
amsp  -   ask me something personal
anim8  -   animate
anlsx  -   anal sex
anon  -   anonymous
anuda  -   another
anoda  -  another
anws  -   anyways
anwwi  -   alright now where was i
any1  -   anyone
anywaz  -   anyways
aota  -   all of the above
aoto  -   Amen on that one
aoys  -   angel on your shoulder
api  -   application program interface
apoc  -   apocalypse
apod  -   Another Point Of Discussion
appt  -   appointment
aprece8  -   appreciate
apreci8  -   appreciate
aqap  -   as quick as possible
arnd  -   around
arse  -   ass
arsed  -   bothered
arvo  -   afternoon
asafp  -   as soon as fucking possible
asaik  -   as soon as I know
asarbambtaa  -   All submissions are reviewed by a moderator before they are added.
asbmaetp  -   Acronyms should be memorable and easy to pronounce
ashl  -   asshole
ashole  -   asshole
aslop  -   Age Sex Location Orientation Picture
asshle  -   asshole
atfp  -   answer the fucking phone
atm  -   at the moment
atop  -   at time of posting
atst  -   At the same time
attn  -   attention
attotp  -   At The Time Of This Post
audy  -   Are you done yet?
aufm  -   are you fucking mental
aufsm  -   are you fucking shiting me
av7x  -   avenged sevenfold
avgn  -   Angry Video Game Nerd
avie  -   Avatar
avsb  -   a very special boy
avtr  -   avatar
avvie  -   avatar
awes  -   awesome
awol  -   absent without leave
awsic  -   and why should i care
awsm  -   awesome
awsome  -   awesome
ayagob  -   are you a girl or boy
aybab2m  -   all your base are belong 2 me
aybab2u  -   All your base are belong to us
aybabtg  -   All Your Base Are Belong To Google
aybabtu  -   all your base are belong to us
aydy  -   are you done yet
ayec  -   at your earliest convenience
ayfk  -   are you fucking kidding
ayfkm  -   are you fucking kidding me
ayfr  -   are you for real
ayfs  -   Are You fucking Serious
aykm  -   are you kidding me
aymf  -   are you my friend
ayok  -   are you okay
aypi  -   And Your Point Is
aypi  -   and your point is
aysm  -   are you shitting me?
ayst  -   are you still there
ayte  -   alright
aytf  -   are you there fucker
ayty  -   are you there yet
azhol  -   asshole
azz  -   ass
07734  -   hello
0vr  -   over
10tacle  -   Tentacle
12b  -   wannabe
1337  -   elite
133t  -   elite
13itch  -   bitch
143  -   I love you
1daful  -   wonderful
1dering  -   wondering
1nce  -   once
1sec  -   one second
2real   -   too real
2b4u  -   too bad for you
2bad4u2  -   too bad for you too 
2bh  -   to be honest
2day  -   today
2ditd  -   today is the day
2ez  -   too easy
2g2b4g  -   To good to be forgotten
2g2bt  -   too good to be true
2ge4  -   Together
2getha  -   together 
2gether  -   together
2gethr  -   together
2getr  -   Together
2h2h  -   too hot to handle
2h4u  -   too hot for you
2m4u  -   too much for you
2maro  -   tomorrow
2mmrw  -   tomorrow
2mo  -   tomorrow
2mora  -   tomorrow
2moro  -   tomorrow
2morow  -   tomorrow
2morro  -   tomorrow
2morrow  -   tommorrow
2moz  -   tomorrow
2mozz  -   tomorrow
2mro  -   tomorrow
2mrw  -   tomorrow
2mw  -   tomorrow
2mz  -   tomorrow
2night  -   tonight
2nite  -   tonight
2nyt  -   tonight
2o4s  -   too old for sex
2sday  -   tuesday
2tali  -   totally
2trd  -   too tired
2u2  -   To you too
301ing  -   referring traffic to another site
3vi1  -   evil
42n8  -   fortunate
4e&e  -   forever and ever
4eva  -   forever
4ever  -   forever
4evr  -   for ever
4evs  -   forever
4g8  -   forget
4gai  -   forget about it
4geit  -   forget it
4get  -   forget
4getu  -   forget you
4give  -   forgive
4got  -   forgot
4head  -   forehead
4hoa  -   four horsemen of the apocalypse
4ker  -   fucker
4king  -   fucking
4lyf3  -   for life
4lyfe  -   for life
4r3al  -   for real
4rm  -   from
4sho  -   for sure
4tlog  -   for the love of god
4tw  -   for the win
4umb  -   For You Maybe
4ward  -   forward
4yeo  -   For Your Eyes Only
5-oh  -   cop
53x  -   sex
5h17  -   shit
6flx  -   X-Rated movie (sex flick)
7734  -   hell
7uck  -   fuck
8008  -   boob
8008135  -   boobies
80085  -   Boobs
81tc#  -   bitch
9009l3  -   Google
911sc  -   emergency let's stop chatting
@$$  -   ass
@$$ #013  -   ass hole
@$$hole  -   asshole
b'day  -   birthday
b-cuz  -   because
b-day  -   birthday
b.f.f.  -   best friend forever
b.s.  -   bullshit
b/c  -   because
b/cos  -   because
b/g  -   background
b/s/l  -   Bisexual/Straight/Lesbian
b/t  -   between
b/w  -   between
b00t  -   boot
b0rked  -   broken
b1tch  -   bitch
b2b  -   business to business
b2u  -   back to you
b2w  -   Back to work
b4  -   before
b4u  -   before you
b4ug  -   before you go
b4ul  -   before you Leave
b82rez  -   Batteries
b8rez  -   Batteries
babi  -   baby
baggkyko  -   be a good girl, keep your knickers on
bai  -   Bye
bak  -   back
bakk  -   back
balz  -   balls
bamofo  -   bitch ass mother fucker
bb4h  -   bros before hoes
bb4n  -   Bye-bye for now
bbbj  -   Bare Back Blow Job
bbf  -   best boy friend
bbfn  -   Bye Bye for now
bbfs  -   best boyfriends
bbfu  -   be back for you
bbiab  -   be back in a bit
bbiaf  -   be back in a few
bbialb  -   Be back in a little bit
bbiam  -   be back in a minute
bbias  -   be back in a second
bbiaw  -   be back in a while
bbifs  -   be back in a few seconds
bbilb  -   be back in a little bit
bbilfm  -   be back in like five minutes
bbim  -   Be Back In Minute
bbl  -   be back later
bbl8a  -   Be Back Later
bblig  -   Be back later...i guess
bbm  -   BlackBerry Messenger
bbml  -   be back much later
bbol  -   be back online later
bbq  -   be back quick
bbrs  -   be back really soon
bbsts  -   be back some time soon
bbtn  -   be back tonite
bbvl  -   Be Back Very Later
bbwb  -   best buddy with boobs
bbwe  -   be back whenever
bbwl  -   be back way later
bby  -   baby
bbz  -   babes
bc  -   because
bcnu  -   be seeing you
bcnul8r  -   be seeing you later
bcoz  -   Because
bcurl8  -   Because you're late.
bcuz  -   because
bday  -   birthday
bdfl  -   Benevolent Dictator For Life
be4  -   before
beatch  -   bitch
becuse  -   because
becuz  -   because
beeoch  -   bitch
beezy  -   bitch
beotch  -   bitch
besos  -   kisses
bestie  -   best friend
betch  -   bitch
betcha  -   bet you
bettr  -   better
bewb  -   boob
bewbs  -   boobs
bewbz  -   boobs
bewt  -   boot
beyatch  -   bitch
beyotch  -   bitch
bezzie  -   best friend
bf  -   boyfriend
bf's  -   boyfriend's
bf+gf  -   boyfriend and girlfriend
bf4e  -   best friends for ever
bf4eva  -   Best Friends forever
bf4l  -   best friends for life
bfam  -   brother from another mother
bff  -   best friend forever
bffa  -   best friends for always
bffaa  -   Best Friends Forever And Always
bffae  -   Best Friends Forever And Ever
bffaw  -   best friends for a while
bffe  -   Best friends forever
bffeae  -   Best Friend For Ever And Ever
bffene  -   Best Friends For Ever And Ever
bffl  -   best friends for life
bffn  -   best friends for now
bfftddup  -   best friends forever till death do us part
bfhd  -   big fat hairy deal
bfitww  -   best friend in the whole world
bft  -   big fucking tits
bhwu  -   back home with you
biab  -   back in a bit
biach  -   bitch
biaf  -   Back In A Few
biatch  -   bitch
bibi  -   bye bye
bibifn  -   bye bye for now
bicbw  -   but I could be wrong
bich  -   bitch
bigd  -   big deal
bii  -   bye
bilf  -   brother i'd like to fuck
bilu  -   baby i love you
bion  -   Believe it or not.
biotch  -   bitch
bioya  -   blow it out your ass
bish  -   bitch
bitd  -   back in the day
biw  -   boss is watching
biwm  -   bisexual white male
biz  -   Business
bizatch  -   bitch
bizi  -   Busy
biznatch  -   bitch
biznitch  -   bitch
bizzle  -   bitch
bk  -   back
bka  -   better known as
bleme  -   blog meme
bleve  -   believe
bling-bling  -   jewelry
bljb  -   Blowjob
blk  -   black
blkm  -   Black Male
bmay  -   between me and you
bmfe  -   best mates forever
bmfl  -   best mates for life
bmha  -   bite my hairy ass
bmoc  -   Big Man On Campus
bmttveot  -   best mates till the very end of time
bmvp  -   be my valentine please
bndm3ovr  -   Bend me over
bnib  -   Brand new in Box
bnol  -   be nice or leave
boati  -   Bend Over And Take It
bobfoc  -   Body of Baywatch, Face of Crimewatch
bobw  -   Best of Both Worlds
boffum  -   Both of them
bofh  -   bastard operator from hell
bogo  -   buy one get one
bogof  -   buy one get one free
bogsatt  -   bunch of guys sitting around the table
bohic  -   Bend over here it comes
bohica  -   bend over, here it comes again
boi  -   boy
bol  -   Barking Out Loud
bonr  -   boner
boomm  -   bored out of my mind
bord  -   bored
botoh  -   but on the other hand
bout  -   about
bovered  -   bothered
bowt  -   about
boxor  -   box
bpot  -   big pair of tits
brb  -   be right back
brbbrb  -   br right back bath room break
brbf  -   Be Right Back fucker
brbg2p  -   be right back, got to pee
brbigtp  -   be right back, i got to pee.
brbl  -   be right back later
brbmf  -   be right back mother fucker
brbn2gbr  -   Be right back, I need to go to the bathroom
brbs  -   be right back soon
brbts  -   be right back taking shit
brfb  -   be right fucking back
brgds  -   best regards
bro  -   brother
bros  -   brothers
broseph  -   brother
brover  -   Brother
bruh  -   brother
bruhh  -   Brother
bruv  -   brother
bruva  -   brother
bruz  -   brothers
bs  -   bullshit
bsmfh  -   bastard System Manager From Hell
bsod  -   blue screen of death
bsomn  -   blowing stuff out my nose
bstfu  -   bitch shut the fuck up
bstrd  -   bastard
bsxc  -   be sexy
btch  -   bitch
btdt  -   been there done that
btdtgtts  -   Been there, done that, got the T-shirt
btfl  -   beautiful
btfo  -   back the fuck off
btfw  -   by the fucking way
btias  -   Be there in a second
btsoom  -   Beats The shit Out Of Me
bttt  -   been there, tried that
bttyl  -   be talking to you later
btw  -   by the way
btwilu  -   by the way i love you
btwitiailwu  -   by the way i think i am in love with you
btwn  -   between
bubar  -   bushed up beyond all recognition
bubi  -   bye
budzecks  -   butt sex
buhbi  -   Bye Bye
bukket  -   bucket
burma  -   be undressed ready my angel
buszay  -   busy
but6  -   buttsex
butsecks  -   butt sex
butterface  -   every thing is hot but her face
buwu  -   breaking up with you
bwim  -   by which i mean
bwoc  -   Big Woman On Campus
bwpwap  -   back when Pluto was a planet
byak  -   blowing you a kiss
byeas  -   good-bye
byes  -   bye bye
bykt  -   But you knew that
byob  -   Bring your own Beer
byoc  -   bring our own computer
byoh  -   bring your own high
byself  -   by myself
bytabm  -   beat you to a bloody mess
bytch  -   bitch
bz  -   busy
bzns  -   buisness
bzy  -   busy
bzzy  -   busy
cant   -   can't
c'mon  -   come on
c-p  -   sleepy
c.y.a  -   cover your ass
c/b  -   comment back
c/t  -   can't talk
c14n  -   canonicalization
c2c  -   care to chat?
c2tc  -   cut to the chase
c4ashg  -   care for a shag
cancer stick  -   cigarette
catwot  -   complete and total waste of time
cawk  -   cock
cayc  -   call at your convenience
cbfa  -   can't be fucking arsed
cbfed  -   can't be fucked
ccna  -   Cisco Certified Network Associate
celly  -   cell phone
cex  -   sex
cexy  -   sexy
cfas  -   care for a secret?
cfid  -   check for identification
cgad  -   couldn't give a damn
cgaf  -   couldn't give a fuck
cgf  -   cute guy friend
ch@  -   chat
champs  -   champions
char  -   character
cheezburger  -   cheeseburger
chik  -   chick
chilax  -   chill and relax in one word
chillax  -   chill and relax
chillin  -   relaxing
chk  -   check
chohw  -   Come Hell or high water
chr  -   character
chronic  -   marijuana
chswm  -   come have sex with me
chswmrn  -   come have sex with me right now
chut  -   pussy
cigs  -   cigarettes
cihswu  -   can i have sex with you
cihyn  -   can i have your number
cilf  -   child i'd like to fuck
cing  -   seeing
ciwwaf  -   cute is what we aim for
im   -  i'm
cless  -   clanless
cluebie  -   clueless newbie
cmao  -   Crying My ass Off
cmar  -   cry me a river
cmb  -   comment me back
cmbo  -   combo
cmcp  -   call my cell phone
cmeo  -   crying my eyes out
cmh  -   Call My House
cmiiw  -   correct me if I'm wrong
cmitm  -   Call me in the morning
cml8r  -   call me later
cmliuw2  -   call me later if you want to
cmomc  -   call me on my cell
cmon  -   Come on
cmplcdd  -   complicated
cmplte  -   complete
cmptr  -   computer
cod4  -   call of duty 4
cod5  -   call of duty 5
code 29  -   moderator is watching
code 8  -   parents are watching
code 9  -   Parents are watching
code9  -   other people near by 
dem  -   them
der  -   there
dernoe  -   I don't know
detai  -   don't even think about it
dewd  -   Dude
dey  -   they
dftba  -   don't forget to be awesome
dftc  -   down for the count
dfw/m  -   Don't fuck with Me
dfwm  -   Don't fuck with Me
dfwmt  -   Don't fucking waste my time
dgac  -   don't give a crap
dgaf  -   don't give a fuck
dgara  -   don't give a rats ass
dgas  -   Don't give a shit
dgms  -   Don't get me started
dgoai  -   don't go on about it
dgypiab  -   don't get your panties in a bunch
dhac  -   Don't have a clue
dhcp  -   Dynamic Host Configuration Protocol
dhly  -   does he like you
diacf  -   die in a car fire
diaf  -   die in a fire
diah  -   die in a hole
diez  -   dies
diff  -   difference
dikhed  -   dickhead
diku  -   do i know you
diky  -   Do I know you
dilf  -   dad i'd like to fuck
dillic  -   Do I look like I care
dillifc  -   do I look like I fucking care
dilligad  -   do I look like I give a damn
dilligaf  -   do I look like I give a fuck
dilligas  -   do i look like i give a shit
didnt  -   didn't
din't  -   didn't
dis  -   this
dl  -   download
dlf  -   dropping like flies
dlibu  -   Dont let it bother you
dln  -   don't look now
dm  -   direct message
dmaf  -   do me a favor
dmn  -   damn
dnt  -   don't
dob  -   date of birth
doin  -   doing
doin'  -   doing
doncha  -   Don't you
donno  -   don't know
dont  -   don't
dontcha  -   don't you
dood  -   dude
doodz  -   dudes
dotc  -   dancing on the ceiling
doypov  -   depends on your point of view
dpmo  -   don't piss me off
dprsd  -   depressed
dqmot  -   don't quote me on this
dqydj  -   don't quit your day job
dr00d  -   druid
dressin  -   dressing
drood  -   druid
dsided  -   decided
dtrt  -   do the right thing
dttm  -   don't talk to me
dttml  -   don't talk to me loser
dttpou  -   Don't tell the police on us
dttriaa  -   don't tell the RIAA
du2h  -   damn you to hell
ducy  -   do you see why
dugi  -   do you get it?
dugt  -   did you get that?
dulm  -   do you like me
dunna  -   i don't know
dunno  -   don't know
duno  -   don't know
dupe  -   duplicate
dutma  -   don't you text me again
dvda  -   double vaginal, double anal
dw  -   don't worry
dwai  -   don't worry about it
dwbh  -   don't worry, be happy
dwbi  -   Don't worry about it.
dwioyot  -   Deal With It On Your Own Time
dwmt  -   don't waste my time
dy2h  -   damn you to hell
dyac  -   damn you auto correct
dycotfc  -   do you cyber on the first chat
dyec  -   Don't You Ever Care
dygtp  -   did you get the picture
dylh  -   do you like him
dylm  -   do you love me
dylos  -   do you like oral sex
dynk  -   do you not know
dynm  -   do you know me
dyth  -   damn You To Hell
e.g.  -  for example
dyw2gwm  -   do you want to go with me
dywtmusw  -   do you want to meet up some where
e4u2s  -   easy for you to say
eabod  -   eat a bag of dicks
ebitda  -   earnings before interest, taxes, depreciation and amortization
edumacation  -   education
eedyat  -   idiot
eejit  -   idiot
ef-ing  -   fucking
efct  -   effect
effed  -   fucked
efffl  -   extra friendly friends for life
effin  -   fucking
effing  -   fucking
ehlp  -   help
el!t  -   elite
eleo  -   Extremely Low Earth Orbit
ello  -   hello
enat  -   every now and then
enuf  -   enough
enuff  -   enough
eotw  -   end of the world
ere  -   here
errythin  -   everything
esad  -   eat shit and die
esadyffb  -   eat shit and die you fat fucking bastard
esbm  -   Everyone sucks but me
etla  -   extended three letter acronym
etmda  -   Explain it to my dumb ass
eula  -   end user license agreement
eva  -   ever
evaa  -   ever
evar  -   ever
every1  -   everyone
evn  -   even
evr  -   ever
evry  -   every
evry1  -   every one
evrytin  -   everything
ex-bf  -   Ex-Boy Friend
ex-gf  -   Ex-Girl Friend
eyez  -   eyes
ez  -   Easy
ezi  -   easy
em   -  them
f#cking  -   fucking
f-ing  -   fucking
f.b.  -   facebook
f.m.l.  -   fuck my life
f.u.  -   fuck you
f/o  -   fuck off
f00k  -   fuck.
f4c3  -   face
f4eaa  -   friends forever and always
f4f  -   female for female
f4m  -   female for male
fa-q  -   fuck you
faggit  -   faggot
faic  -   For All I Care
fankle  -   area between foot and ankle
fapping  -   masterbating
faq  -   frequently asked question
farg  -   fuck
fashizzle  -   for sure
fav  -   Favorite
fave  -   favorite
fawk  -   fuck
fbimcl  -   Fall Back In My Chair Laughing
fbk  -   facebook
fbtw  -   Fine Be That Way
fcbk  -   facebook
fcfs  -   first come first served
fck  -   fuck
fckd  -   fucked
fckin  -   fucking
fcking  -   fucking
fckm3hdbayb  -   fuck Me Hard Baby
fcku  -   fuck you
fcol  -   for crying out loud
fcuk  -   fuck
feelin  -  feeling
feck  -   fuck
fer  -   for
ferr  -   for
feat.   - featuring
ffcl  -   falling from chair laughing
ffxi  -   Final Fantasy 11
fgssu  -   For Gods sake shut up
fi9  -   fine
fibijar  -   fuck it buddy, I'm just a reserve
fifo  -   first in, first out
fify  -   Fixed It For You
figjam  -   fuck I'm good, just ask me
figmo  -   fuck it - got my orders
fiic  -   fucked If I Care
fiik  -   fucked If I Know
fimh  -   forever in my heart
fitb  -   fill in the blank
fiv  -   five
fk  -   fuck
fka  -   formerly known as
fkd  -   fucked
fker  -   fucker
fkin  -   fucking
fking  -   fucking
fkn  -   fucking
fku  -   fuck you
flamer  -   angry poster
flames  -   angry comments
flicks  -   pictures
floabt  -   for lack of a better term
fmah  -   fuck my ass hole
fmao  -   freezing my ass of
fmbb  -   fuck Me Baby
fmbo  -   fuck my brains out
fmfl  -   fuck my fucking life
fmflth  -   fuck My fucking Life To Hell
fmhb  -   fuck me hard bitch
fmir  -   family member in room
fmita  -   fuck me in the ass
fml  -   fuck my life
fmltwia  -   fuck me like the whore I am
fmn  -   fuck me now
fmnb  -   fuck me now bitch
fmnkml  -   fuck me now kiss me later
fmph  -   fuck my pussy hard
fmsh  -   fuck me so hard
fmth  -   fuck me to hell
fmuta  -   fuck me up the ass
fmutp  -   fuck me up the pussy
fnar  -   For No Apparent Reason
fnci  -   fancy
fnny  -   funny
fnpr  -   for no particular reason
fo shizzle  -   for sure
fo sho  -   for sure
foad  -   fuck off and die
foaf  -   friend of a friend
foah  -   fuck off asshole
focl  -   Falling Off Chair Laughing.
fofl  -   fall on the floor laughing
foia  -   freedom of information act
folo  -   Follow
fomofo  -   fuck off mother fucker
fone  -   phone
foobar  -   fucked up beyond all recognition
foocl  -   falls out of chair laughing
fook  -   fuck
for sheeze  -   for sure
foshizzle  -   for sure
fosho  -   for sure
fotcl  -   fell off the chair laughing
fotm  -   Flavour of the month
fouc  -   fuck off you cunt 
foyb  -   fuck off you bitch
fpmitap  -   federal pound me in the ass prison
fpos  -   fucking piece of shit
fps  -   First Person Shooter
frag  -   kill
fragged  -   killed
fren  -   friend
frens  -   friends
frgt  -   forgot
fri.  -   Friday
friggin  -   freaking
frk  -   freak
frm  -   from
frnd  -   friend
frnds  -   friends
fsho  -   for sure
fsob  -   fucking son of a bitch
fsod  -   frosn screen of death
ft2t  -   From time to time
fta  -   From The Article
ftb  -   fuck That bitch
ftbfs  -   Failed to build from source
ftf  -   face to face
ftfa  -   From The fucking Article
ftfw  -   For the fucking win!
ftfy  -   Fixed that for you
ftio  -   fun time is over
ftlog  -   for the love of god
ftlt  -   For the last time
ftmfw  -   for the mother fucking win
ftmp  -   For the most part
fttp  -   for the time being
ftw  -   For the win
fuah  -   fuck you ass hole
fubah  -   fucked up beyond all hope
fubalm  -   fucked up beyond all local maintenance
fubar  -   fucked up beyond all recognition
fubb  -   fucked up beyond belief
fubh  -   fucked up beyond hope
fubohic  -   fuck you Bend over here it comes
fubr  -   fucked Up Beyond Recognition
fucken  -   fucking
fucktard  -   fucking retard
fuctard  -   fucking retard
fudh  -   fuck you dick head
fudie  -   fuck you and die
fugly  -   fucking ugly
fuh-q  -   fuck you
fuhget  -   forget
fukin  -   fucking
fuckin  -  fucking
fukk  -   fuck
fukkin  -   fucking
fukn  -   fucking
fukr  -   fucker
fulla  -   Full of
fumfer  -   fuck you mother fucker
funee  -   funny
funner  -   more fun
funy  -   funny
fuxing  -   fucking
fuxor  -   fucker
fuxored  -   fucked
fvck  -   fuck
fwb  -   Friends with Benefits
fwd  -   forward
fwiw  -   for what it's worth
fwob  -   friends with occasional benefits
fya  -   for your attention
fyad  -   fuck you and die
fyah  -   fuck you asshole
fyeo  -   For your eyes only
fyfi  -   For Your fucking Information
fyrb  -   fuck you right back
fytd  -   fuck you to death
g'nite  -   good night
g/f  -   girlfriend
g/g  -   got to go
g0  -   go
g00g13  -   Google
g2/-/  -   go to hell
g2bg  -   got to be going
g2bl8  -   going to be late
g2cu  -   glad to see you
g2g  -   got to go
g2g2tb  -   got to go to the bathroom
g2g2w  -   got to go to work
g2g4aw  -   got to go for a while
g2gb  -   got to go bye
g2gb2wn  -   got to go back to work now
g2ge  -   got to go eat
g2gn  -   got to go now
g2gp  -   got to go pee
g2gpc  -   got 2 go parents coming
g2gpp  -   got to go pee pee
g2gs  -   got to go sorry
g2hb  -   go to hell bitch
g2t2s  -   got to talk to someone
g3y  -   gay
g4u  -   good for you
g4y  -   good for you
g8  -   gate
g9  -   good night
g@y  -   gay
ga  -   go ahead
gaalma  -   go away and leave me alone
gaf  -   good as fuck
gafi  -   get away from it
gafl  -   get a fucking life
gafm  -   Get away from me
gagf  -   go and get fucked
gagp  -   go and get pissed
gamez  -   illegally obtained games
gangsta  -   gangster
gaoep  -   generally accepted office etiquette principles
gaw  -   grandparents are watching
gawd  -   god
gbioua  -   Go blow it out your ass
gbnf  -   Gone but not forgotten 
gbtw  -   go back to work
gd  -   good
gd&r  -   grins, ducks, and runs
gd4u  -   Good For You
gday  -   Good Day
gdby  -   good bye
gded  -   grounded
gdgd  -   good good
gdiaf  -   go die in a fire
gdih  -   Go die in hell
gdilf  -   Grandad I'd Like To fuck
gdmfpos  -   god damn mother fucking piece of shit
gemo  -   gay emo
getcha  -   get you
geto  -   ghetto
gettin  - getting
gewd  -   good
gf  -   girlfriend
gfad  -   go fuck a duck
gfadh  -   go fuck a dead horse
gfak  -   go fly a kite
gfam  -   Go fuck A Monkey
gfar2cu  -   go find a rock to crawl under
gfas  -   go fuck a sheep
gfe2e  -   grinning from ear to ear
gfgi  -   go fucking google it
gfurs  -   go fuck yourself
gfus  -   go fuck yourself
gfyd  -   go fuck your dad
gfym  -   go fuck your mom
gfys  -   go fuck yourself
gga  -   good game all
ggal  -   go get a life
ggnore  -   good game no rematch
ggpaw  -   gotta go parents are watching
ghei  -   Gay
ghey  -   gay
gigig  -   get it got it good
gigo  -   garbage in garbage out
gilf  -   Grandma I'd like to fuck
gimme  -   give me
gimmie  -   give me
gitar  -   guitar
giv  -   give
giyf  -   google is your friend
gjial  -   go jump in a lake
gjsu  -   god just shut up
gkys  -   Go kill yourself
gl hf  -   good luck, have fun
gl&hf  -   good luck and have fun
glbt  -   Gay, lesbian, bisexual, transgenderd
glhf  -   good luck have fun
glln  -   Got Laid Last Night
glnhf  -   Good Luck and Have Fun
glty  -   Good luck this year
glu2  -   good luck to you too
glux  -   good luck
glwt  -   good luck with that
gmab  -   give me a break
gmabj  -   give me a blowjob
gmafb  -   give me a fucking break
gmao  -   Giggling my ass off
gmfao  -   Giggling My fucking ass Off
gmilf  -   grandmother i'd like to fuck
gmod  -   Global Moderator
gmta  -   great minds think alike
gmtyt  -   good morning to you too
gmybs  -   give me your best shot
gn8  -   good night
gnasd  -   good night and sweet dreams
gndn  -   Goes nowhere,does nothing
gnfpwlbn  -   good news for people who love bad news
gng  -   going
gng2  -   going to
gngbng  -   gang bang
gnight  -   good night
gnite  -   good night
gnn  -   get naked now
gno  -   going to do
gnoc  -   get naked on cam
gnos  -   get naked on screen
gnr  -   Guns n' roses
gnrn  -   get naked right now
gnst  -   goodnight sleep tight
gnstdltbbb  -   good night sleep tight don't let the bed bugs bite
goia  -   get over it already
goin  -   going
gokid  -   got observers - keep it decent
gokw  -   God Only Knows Why
gomb  -   get off my back
goml  -   get out of my life
gon -  gonna
gona  -   Gonna
good9  -   goodnite
gooh  -   get out of here!
goomh  -   get out of my head
gork  -   God only really knows
gosad  -   go suck a dick
gotc  -   get on the computer
gotcha  -   got you
goya  -   Get Off Your ass
goyhh  -   get off your high horse
gpb  -   gotta pee bad
gpwm  -   good point well made
gpytfaht  -   gladly pay you tuesday for a hamburger today
gr8  -   great
gr8t  -   great
grats  -   congratulations
gratz  -   congratulations
grfx  -   graphics
grillz  -   metal teeth
grl  -   girl
grmbl  -   grumble
grog  -   beer
grrl  -   Girl
grtg  -   Getting ready to go
grvy  -   groovy
gsad  -   go suck a dick
gsave  -   global struggle against violent extremists
gsfg  -   Go search fucking google
gsoh  -   Good Sense of Humor
gsta  -   Gangster
gtas  -   go take a shit
gtb  -   Go To Bed
gtf  -   get the fuck
gtfa  -   Go The fuck Away
gtfbtw  -   get the fuck back to work
gtfh  -   go to fucking hell
gtfo  -   get the fuck out
gtfoi  -   get the fuck over it
gtfon  -   Get the fuck out noob
gtfooh  -   get the fuck out of here
gtfoomf  -   get the fuck out of my face
gtfu  -   grow the fuck up
gtfuotb  -   get the fuck up out this bitch
gtg  -   got to go
gtgb  -   got to go bye
gtgbb  -   got to go bye bye
gtgfn  -   got to go for now
gtgmmiloms  -   got to go my mum is looking over my shoulder
gtgn  -   got to go now
gtgp  -   got to go pee
gtgpp  -   got to go pee pee
gtgtb  -   got to go to bed
gtgtpirio  -   got to go the price is right is on
gtgtwn  -   Got to go to work now
gtha  -   go the hell away
gthb  -   go to hell bitch
gthmf  -   go to hell mothafucka
gtho  -   get the hell out
gthu  -   grow the heck up
gthyfah  -   go to hell you fucking asshole
gtsy  -   good to see you
gttp  -   get to the point
gtty  -   good talking to you
gu2i  -   get used to it 
h.o  -   hold on
h/e  -   However
h/mo  -   homo
h/o  -   hold on
h/u  -   hold up
h/w  -   homework
h2gtb  -   have to go to the bathroom
h2sys  -   hope to see you soon
h3y  -   hey
h4kz0r5  -   hackers
h4x  -   Hacks
h4x0r  -   hacker
h4xor  -   hacker
h4xr  -   hacker
h4xrz  -   hackers
h4xx0rz  -   hacker
h4xxor  -   hacker
h8  -   hate
h80r  -   hater
h82sit  -   hate to say it
h83r  -   hater
h8ed  -   hated
h8er  -   hater
h8r  -   hater
h8red  -   Hatred
h8s  -   hates
h8t  -   hate
h8t0r  -   hater
h8t3r  -   hater
h8te  -   hate
h8tr  -   hater
habt  -   how about this
hafta  -   have to
hagd  -   have a good day
hagl  -   have a great life
hagn  -   have a good night
hago  -   have a good one
hags  -   have a great summer
hait  -   hate
hakas  -   have a kick ass summer
hammrd  -   hammered
hav  -   have
havnt  -   haven't
hawf  -   Husband and Wife forever
hawt  -   hot
hawtie  -   hottie
hax  -   Hacks
hax0r  -   hacker
hax0red  -   hacked
hax0rz  -   Hackers
haxer  -   Hacker
haxor  -   hacker
haxoring  -   hacking
haxors  -   hackers
haxorz  -   hackers
haxxor  -   hacker
haxxzor  -   Hacker
haxz0r  -   Hacker
haxzor  -   hacker
hayd  -   how are you doing
hb4b  -   hoes before bros
hbd  -   happy birthday
hbic  -   head bitch in charge
hbii  -   how big is it
hcbt1  -   he could be the one
hcib  -   how can it be
hcihy  -   how can I help you
hdop  -   Help Delete Online Predators
hdydi  -   How do you do it
hdydt  -   how did you do that
heya  -   hey
heyt  -   hate
heyy  -   hello
heyya  -   hello
hfsbm  -   holy fucking shit batman
hfwt  -   have fun with that
hght  -   height
hhiad  -   holy hole in a doughnut
hhiadb  -   Holy Hole in a Donut Batman
hhok  -   Ha Ha Only Kidding
hhyb  -   how have you been
hi2u  -   hello
hi2u2  -   hello to you too
hiet  -   height
hiik  -   Hell If I Know
hijack  -   start an off topic discussion
hith  -   how in the hell
hiya  -   hello 
hiybbprqag  -   copying somebody else's search results
hldn  -   hold on
hldon  -   hold on
hlo  -   hello
hlp  -   help
hlysht  -   Holy shit
hmewrk  -   homework
hmfic  -   head mother fucker in charge
hml  -   hate my life
hmoj  -   holy mother of jesus
hmul  -   Hit me up later
hmus  -   Hit me up sometime
hmwk  -   homework
hmwrk  -   Homework
hngry  -   hungry
hnic  -   head nigger in charge
hoas  -   Hang on a second
hoay  -   how old are you
hoopty  -   broke down automobile
hott  -   hot
howdey  -   hello
howz  -   hows
hpoa  -   Hot Piece of ass
hppy  -   Happy
hpy  -   happy
hpybdy  -   happy birthday
hr  -   hour
hrny  -   horny
hrs  -   hours
hrud  -   how are you doing
hsik  -   how should i know
hswm  -   Have Sex With me
htfu  -   Hurry the fuck up
hthu  -   Hurry the hell up
htr  -   hater
hubby  -   husband
huggle  -   hug and cuddle
hugz  -   hugs
hv  -   have
hve  -   have
hvnt  -   haven't
hw/hw  -   help me with homework 
hwg  -   here we go
hwga  -   here we go again
hwik  -   how would i know
hwmbo  -   he who must be obeyed
hwmnbn  -   he who must not be named
hwms  -   hot wild monkey sex
hwu  -   hey what's up
i <3 u  -   I love you
i8u  -   i hate you
i<3 u  -   i love you
i<3u  -   I love you
ianabs  -   I am not a brain surgeon
ianacl  -   I am not a copyright lawyer
ianal  -   I am not a lawyer
ianalb  -   I am not a lawyer, but..
ianars  -   I am not a rocket scientist
iaspfm  -   i am sorry please forgive me
iatb  -   I am the best
iateu  -   i hate you
iavb  -   i am very bored
iawtc  -   I agree with this comment
iawtp  -   I agree with this post
iawy  -   I agree with you
ibbl  -   I'll be back later
ibcd  -   Idiot between chair & desk
ibtl  -   In Before The Lock
icbi  -   i can't believe it
icbiwoop  -   I chuckled, but it was out of pity.
icbt  -   i can't believe that
icbu  -   I can't believe you
icbyst  -   i cant believe you said that
iccl  -   I could care less
icgup  -   I can give you pleasure
icic  -   I See. I See
icsrg  -   I can still reach Google
ictrn  -   I can't talk right now
icty  -   i can't tell you 
icudk  -   in case you didn't know
icwudt  -   I see what you did there
icwum  -   I see what you mean
icydk  -   in csae you didn't know
icydn  -   in case you didn't know
id10t  -   idiot
idbtwdsat  -   I don't believe they would do such a thing
idby  -   I Don't Believe You
iddi  -   I didn't do it
idec  -   I don't even care
idek  -   I don't even know
idfc  -   i don't fucking care
idfk  -   i don't fucking know
idfts  -   I don't fucking think so
idgac  -   i don't give a crap
idgad  -   I don't give a damn
idgaff  -   I don't give a flying fuck
idgafs  -   I don't give a fucking shit
idgara  -   I don't give a rat's ass
idgas  -   i don't give a shit
idgi  -   I don't get it
idjit  -   idiot
idk  -   I don't know
idkbibt  -   I don't know but I've Been Told
idke  -   I don't know ethier
idkh  -   I don't know how
idkh2s  -   i don't know how to spell
idkt  -   I don't know that
idkw  -   I don't know why
idkwiwdwu  -   I don't know what I would do without you
idkwts  -   I don't know what to say
idkwurta  -   I don't know what you are talking about.
idkwym  -   I don't know what you mean
idky  -   I don't know you
idkyb  -   i don't know why but
idkymb2  -   I didn't know yoru mom blogs too
idli  -   I don't like it
idlu  -   i don't like you
idly  -   I don't like you
idlyitw  -   i don't like you in that way
idnk  -   i don't know
idno  -   i do not know
idntk  -   i dont need to know
idnwths  -   i do not want to have sex
idonno  -   i do not know
idop  -   it depends on price
idrc  -   i don't really care
idrfk  -   I don't really fucking know
idrgaf  -   I don't really give a fuck
idrgaff  -   i don't really give a flying fuck
idrk  -   i don't really know
idrts  -   I don't really think so
idsw  -   i don't see why
idtis  -   I don't think I should
idtkso  -   i don't think so
idts  -   i don't think so
idunno  -   i do not know
iduwym  -   I don't understand what you mean.
idw2  -   I don't want to
idw2n  -   i don't want to know
idwk  -   I don't wanna know
idwt  -   i don't want to
idwtg  -   I don't want to go
idyat  -   idiot
iebkac  -   issue exists between keyboard and chair
ietf  -   internet engineering task force
ifhu  -   I fucking hate you
ifhy  -   i fucking hate you
iflu  -   i fucking love you
ifthtb  -   i find that hard to belive
ifttt  -   if this then that 
ifwis  -   I forgot what I said
ig2g  -   I got to go
ig5oi  -   I got 5 on it 
igahp  -   I've got a huge penis
igalboc  -   I've got a lovely bunch of cocnuts
igkymfa  -   I'm gonna kick your mother fucking ass
igtg  -   i've got to go
igtgt  -   I got to go tinkle
igtkya  -   im going to kick your ass
igyb  -   I Got Your Back
ih2gp  -   I have to go pee
ih2p  -   i'll have to pass
ih8mls  -   I hate my little sister 
ih8p  -   I hate parents
ih8tu  -   i hate you
ih8u  -   I hate you
ih8usm  -   i hate you so much
ih8y  -   I hate you
ihac  -   I have a customer
ihat3u  -   I hate you
ihistr  -   i hope i spelled that right
ihiwydt  -   I hate it when you do that
ihml  -   I hate my life
ihmp  -   i hate my parents
ihnc  -   i have no clue
ihnfc  -   I have no fucking clue
ihni  -   i have no idea
ihtfp  -   I hate this fucking place
ihtgttbwijd  -   I have to go to the bathroom, wait I just did.
ihtp  -   I Have To Poop
ihtsm  -   i hate this so much
ihtutbr  -   I have to use the bathroom
ihurg  -   i hate your guts
ihusb  -   i hate you so bad 
ihusfm  -   i hate you so fucking much
ihusm  -   i hate you so much
ihya  -   i hate you all
ihysm  -   I hate you so much
ihysmrn  -   i hate you so much right now
iight  -   alright
iiok  -   is it okay
iirc  -   if I recall correctly
iistgtbtipi  -   If It Sounds Too Good To Be True It Probably Is
iit  -   is it tight
iitywimwybmad  -   if I tell you what it means will you buy me a drink
iitywybmad  -   if I tell you, will you buy me a drink?
iiuc  -   if I understand correctly
iiw2  -   is it web 2.0?
iiwii  -   it is what it is
ijaf  -   it's just a fact
ijcomk  -   i just came on my keyboard
ijdk  -   I just don't know
ijdl  -   I just died laughing
ijeomk  -   I just ejaculated on my keybord
ijgl  -   I just got laid
ijit  -   idiot
ijpmp  -   I just peed my pants
ijpms  -   I just pissed myself
ijr  -   i just remembered
ijsabomomcibstg  -   I just saved a bunch of money on my car insurance by switching to geico
ikwud  -   I know what you did
ikwum  -   I know what you meant
ikwyl  -   I know where you live
ikwym  -   i know what you mean
ilbbaicnl  -   I like big butts and I can not lie
ilbcnu  -   i'll be seeing you
ilcul8r  -   I'll see you later
ilhsm  -   i love him/her so much
ilk2fku  -   I would like to fuck you
ilml  -   I Love My Life
ilms  -   I love my self
ilotibinlirl  -   I'm laughing on the internet, but I'm not laughing in real life
ilshipmp  -   I laughed so hard I peed my pants
iltf  -   i love to fuck
ilu2  -   I love you too
iluaaf  -   i love you as a friend
ilulafklc  -   I love you like a fat kid loves cake.
ilum  -   i love you more
ilusfm  -   I love you so fucking much
ilusm  -   I love you So much
iluvm  -   I Love You Very Much
iluvu  -   i love you
iluvya  -   i love you
iluwamh  -   i love you with all my heart
ilvu  -   i love you
ily2  -   i love you too
ily4e  -   i love you forever
ily4ev  -   i love you forever
ilyaas  -   I Love You As A Sister
ilyal  -   I like you a lot
ilyb  -   i love you bitch
ilybby  -   i love you baby
ilybtid  -   I Love You But Then I Don't
ilyf  -   I'll Love You Forever
ilygsm  -   i love you guys so much
ilykthnxbai  -   i love you k thanks bye
ilyl  -   i love you loads
ilylab  -   I love you like a brother
ilylabf  -   I love you like a best friend
ilylafklc  -   i love you like a fat kid loves cake
ilylas  -   i love you like a sister
ilylc  -   i love you like crazy
ilym  -   i love you more
ilymtyk  -   i love you more than you know
ilymtylm  -   i love you more than you love me
ilysfm  -   i love you so fucking much
ilysfmb  -   i love you so fucking much baby
ilysm  -   i love you so much
ilysmih  -   i love you so much it hurts
ilysmm  -   i love you so much more
ilysmydek  -   I Love You So Much You Don't Even Know
ilysvm  -   i love you so very much
ilyvm  -   i love you very much
ilywamh  -   I love you with all my heart
im	-	i'm
im'd  -   instant messaged
im26c4u  -   I am too sexy for you
imao  -   in my arrogant opinion
imcdo  -   in my conceited dogmatic opinion
imed  -   instant messaged
imfao  -   In My fucking Arrogant Opinion
imfo  -   in my fucking opinion
imhbco  -   In my humble but correct opinion
imhe  -   in my humble experience
imma  -   I'm going to
imnerho  -   In my not even remotely humble opinion
imnl  -   I'm not laughing
imnshmfo  -   In My Not So Humble Mother fucking Opinion
imnsho  -   in my not so humble opinion
imo  -   in my opinion
imoo  -   in my own opinion
impo  -   In My Personal Opinion
impov  -   in my point of view
imsb  -   i am so bored
imsry  -   I am sorry
imtaw  -   it may take a while
imts  -   I meant to say
imusm  -   I miss you so much
imvho  -   in my very humble opinion
imwtk  -   Inquiring minds want to know
imy2  -   i miss you to
imya  -   i miss you already
imysfm  -   i miss you so fucking much
inb4  -   in before
inbd  -   it's no big deal
incld  -   include
incrse  -   increase
ind2p  -   I need to pee
indie  -   independent
inef  -   it's not even funny
inet  -   internet
inho  -   in my honest opinion
inhwh  -   I need homework help
init  -   isn't it
inmp  -   it's not my problem
innit  -   isn't it
instagib  -   instant kill
instakill  -   instant kill
intarwebs  -   internet
intel  -   intelligence
interweb  -   internet
intpftpotm  -   I nominate this post for the post of the month
inttwmf  -   I am Not Typing This With My Fingers
iokiya  -   it's ok if you are
ionno  -   I don't know
iono  -   I don't know
iotd  -   image of the day
ioya  -   I'd Own Your ass
ioyk  -   if only you knew
irdc  -   I really don't care
irdgaf  -   i really don't give a fuck
irdk  -   I really don't know
irgtgbtw  -   I've really got to get back to work
irhtgttbr  -   I really have to go to the bathroom
irhy  -   i really hate you
irly  -   I really love you
irtf  -   I'll return the favor
is2g  -   i swear to god
isbya  -   im sorry but you asked
isfly  -   i so fucking love you
ishii  -   i see how it is
isianmtu  -   I swear I am not making this up
istr  -   I seem to remember
istwfn  -   I stole this word from noslang.com
iswydt  -   i see what you did there
ityltk  -   I thought you'd like to know
itzk  -   it's ok
iucmd  -   if you catch my drift
iukwim  -   if you know what i mean
iunno  -   I don't know
iuno  -   i dunno
ive   -   i've
iw2f  -   i want to fuck
iw2fu  -   i want to fuck you
iw2mu  -   I want to meet you
iwbrbl@r  -   I will be right back later
iwfusb  -   i wanna fuck you so bad
iwfy  -   I want to fuck you
iwfybo  -   i will fuck your brains out
iwhi  -   I would hit it
iwhswu  -   I want to have sex with you
iwjk  -   i was just kidding
iwlu4e  -   I will love you for ever
iwmu  -   i will miss you
iwmy  -   i will miss you
iwsn  -   i want sex now
iwsul8r  -   I will see you later
iwtfu  -   i want to fuck you
iwtfy  -   i want to fuck you
iwthswy  -   i want to have sex with you
iwtly  -   i want to love you
iwuwh  -   i wish you were here 
iwyb  -   I want your body
iwyn  -   I want you now
iwythmb  -   i want you to have my baby
iyam  -   if you ask me
iydhantsdsaaa  -   If you don't have anything nice to say don't say anything at all
iydmma  -   if you don't mind me asking
iyflg  -   If You're Feeling Less Generous
iygm  -   if you get me
iykwim  -   if you know what I mean
iyswim  -   if you see what I mean
iywt  -   if you want to
iz  -   is
ima - I'm going to
j-c  -   just chilling
j/a  -   Just Asking
j/c  -   just curious
j/j  -   just joking
j/k  -   just kidding
j/o  -   jackoff
j/p  -   just playing
j/s  -   just saying
j/t  -   just talking
j/w  -   just wondering
j2luk  -   just to let you know
j2lyk  -   just to let you know
j4f  -   just for fun
j4g  -   just for grins
j4l  -   just for laughs
j4u  -   just for you
jalaudlm  -   just as long as you don't leave me
jcam  -   just checking away message
jcath  -   Just chilling at the house
jdfi  -   Just fucking do it
jebus  -   Jesus
jeomk  -   Just ejaculated on my keyboard
jfdi  -   Just fucking Do It!
jfgi  -   just fucking google it
jflts  -   just felt like typing something
jfwy  -   just fucking with you
jg2h  -   just go to hell
jgiyn  -   Just google it you noob
jgtfooh  -   just get the fuck out of here
jizz  -   semen
jj/k  -   just joking
jking  -   joking
jklol  -   Just Kidding Laughing Out Loud
jkn  -   joking
jks  -   jokes
jkz  -   jokes
jlma  -   just leave me alone
jooc  -   just out of curiosity
jooce  -   Juice
joor  -   your
jsing  -   just saying
jst  -   just
jsuk  -   just so you know
jsun  -   Just so you know
jsut  -   just
jsyk  -   Just so you know
jsyn  -   just so you know
jtay  -   just thinking about you
jtbs  -   Just To Be Sure
jtfo  -   joke the fuck out
jtluk  -   just to let you know
jtlyk  -   just to let you know
jtoi  -   just thought of it
jtol  -   just thinking out loud
jttsiowctw  -   just testing to see if other websites copy this word
jtty  -   just to tell you
jtumltk  -   just thought you might like to know
jtwii  -   just the way it is.
jtwiw  -   just the way it was.
jtyltk  -   just thought you'd like to know
jtysk  -   just thought you should know
jumping the couch  -   acting strange
jus  -   just
juss  -   just
juz  -   just
juzt  -   just
jw2k  -   just wanted to know
jwas  -   just wait a second
khitbash  -   kick her in the box and shove her
khuf  -   know how you feel
kicks  -   sneakers
kiled  -   killed
kinda  -   kind of
kisa  -   knight in shining armor
kitfo  -   knock it the fuck off
kitteh  -   kitten
kiwf  -   Kill It With Fire
kk  -   ok
kkthnxbye  -   okay thanks bye
kmag  -   kiss my ass goodbye
kmao  -   kick my ass off
kmfa  -   kiss my fucking ass
kmhba  -   kiss my hairy big ass
kmsl  -   killing myself laughing
kmswl  -   killing myself with laughter
knackered  -   drunk
knewb  -   new player
knw  -   know
kol  -   kiss on lips
koo  -   cool
kool  -   cool
kotc  -   kiss on the cheek
kotl  -   kiss on the lips
kotor  -   Knights of the old republic
kots  -   keep on talking shit
kss  -   kiss
kssd  -   kissed
ktfo  -   knocked the fuck out
kthanxbi  -   Okay, thanks. Bye.
kthnxbai  -   Okay, thanks, bye
kthnxbye  -   Okay, thanks, bye
kthx  -   ok, thank you
kthxbai  -   ok thanks bye!
kthxbi  -   ok, thank you, goodbye
kthxbye  -   ok, thank you, goodbye
kthxbye  -   ok, thank you, goodbye
kthxgb  -   ok thanks goodbye
kthxmn  -   Ok Thanks Man
kthz  -   ok thanks
ktnx  -   Okay and Thanks
kuhl  -   cool
kute  -   cute
kutgw  -   Keep Up The good Work
kuwl  -   cool
kwik  -   quick
kwim  -   Know What I Mean
kwis  -   Know what I'm saying?
kwit  -   quit
kwiz  -   quiz
kwl  -   cool
kwtsds  -   Kiss where the sun don't shine
kyag  -   Kiss Your ass Goodbye
kyfag  -   kiss your fucking ass goodbye
kyfc  -   keep your fingers crossed
kyko  -   keep your knickers on
l0lz  -   laughing out loud
l2  -   learn to
l2m  -   listening to music
l2ms  -   laughing to myself
l337  -   elite
l33t  -   elite
l4m3rz  -   lamers
l8  -   late
l84skool  -   late for school
l8a  -   later
l8er  -   later
l8ers  -   Later
l8r  -   see you later
l8rs  -   laters
l8rz  -   later
l8s  -   later
l8t  -   later
l8ta  -   later
l8ter  -   later
l8tr  -   later
l@u  -   laughing at you
laff  -   laugh
lafs  -   love at first sight
lalol  -   lots and lots of laughs
lamf  -   like a motherfucker
lappy  -   Laptop
larp  -   live action role-play
lasb  -   Lame ass Stupid bitch
lata  -   later
lates  -   later
latn  -   laugh at the newbs
latr  -   Later
latwttb  -   laughing all the way to the bank
lawd  -   lord
lawl  -   lauging out loud with a southern drawl
lawl'd  -   laughed out loud
lawled  -   laughed out loud
lawls  -   laughing out loud with a southern drawl
lawlz  -   laughing out loud with a southern drawl
lazer  -   laser
lazor  -   laser
lbnr  -   laughing but not really
lbvs  -   laughing but very serious
lcsnpc  -   low cost small notebook personal computer
lee7  -   elite
leet  -   elite
legit  -   legitimate
leik  -   like
leme  -   let me
lemme  -   let me
lesbo  -   lesbian
less than 3  -   love
less than three  -   love
lezbean  -   lesbian
lezbo  -   lesbian
lezzzie  -   lesbian
lf1m  -   Looking for one more
lf2m  -   looking for 2 more
lfnar  -   laughing for no aparent reason
lgbnaf  -   lets get butt naked and fuck
lgbtq  -   Lesbien, Gay, Bisexual, Transgender and Queer.
lggd  -   let's go get drunk
lgot  -   let's go out tonight
lhao  -   laughing her ass off
lhsrn  -   let's have sex right now
liec  -   like i even care
liek  -   like
liekz  -   likes
lifo  -   last in first out
ligaff  -   like I give a flying fuck
ligafs  -   like I give a flying shit
ligas  -   like I give a shit
liita  -   love is in the air
lik  -   like
lil  -   little
limh  -   laugh in my head
liol  -   laugh insanely out loud
lirl  -   laughing in real life
liu  -   Look It Up
liv  -   live
liyf  -   laughing in your face
lke  -   like
llab  -   Laughing like a bitch.
llap  -   live long and prosper
llol  -   literally laughing out loud
lltnt  -   live like theres no tomorrow 
lm4aq  -   Let's meet for a quickie.
lmamf  -   leave me alone mother fucker
lmao  -   laughing my ass off
lmaoo - laughing my ass off
lmaol  -   laughing my ass out loud
lmaomtoaoa  -   Laugh my ass off many times over and over again
lmaonade  -   laughing my ass off
lmaool  -   laughing my ass off out loud 
lmaootf  -   Laughing my ass off on the floor 
lmaorof  -   Laughing my ass off Rolling on the floor
lmaorotf  -   laughing my ass off rolling on the floor
lmaowrotf  -   Laughing my ass of while rolling on the floor
lmaowtntpm  -   laughing my ass off whilst trying not to piss myself
lmaoxh  -   laughing my ass off extremely hard
lmap  -   leave me alone please
lmbao  -   laughing my black ass off
lmbfwao  -   laughing my big fat white ass off
lmbo  -   laughing my butt off
lmcao  -   laughing my crazy ass off
lmclao  -   laughing my cute little ass off
lmfao  -   laughing my fucking ass off
lmfbo  -   laugh my fucking butt off
lmffao  -   laughing my fucking fat ass off
lmffo  -   Laughing my fucking face off
lmfho  -   laughing my fucking head off
lmfo  -   laughing my face off
lmfpo  -   laughing my fucking pussy off
lmfr  -   Lets Meet For Real
lmfto  -   laughing my fuckin tits off
lmgdao  -   Laughing My God damn ass Off
lmgtfy  -   Let me Google that for you
lmhao  -   laughing my hairy ass off
lmho  -   laughing my heiny off
lmip  -   LETS MEET IN PERSON
lmirl  -   Let's meet in real life
lmks  -   Let Me Know Soon
lmkwut  -   let me know what you think
lmmfao  -   laughing my mother fucking ass off
lmmfaos  -   laughing my mother fucking ass off silly
lmmfas  -   laugh my mother fuckin ass off
lmmffao  -   laughing my mother fucking fat ass off
lmoao  -   Laughing my Other ass Off
lmpo  -   laughing my panties off
lmsao  -   laughing my sexy ass off
lmso  -   laughing my socks off
lmtd  -   limited
lmtfa  -   leave me the fuck alone
lmto  -   laughing my tits off
lmtus  -   let me tell you something
lmty  -   laughing more than you
lmvo  -   laugh my vagina off
lnk  -   Link
lobfl  -   Laugh Out Bloody fucking Loud
lof  -   Laughing on floor
lofi  -   uncool
lofl  -   laugh out fucking loud
loflmao  -   laying on floor laughing my ass off
lol  -   laughing out loud
lol'd  -   laughed out loud
lold   -  laughed out loud
lol2u  -   Laugh out loud to you
lol@u  -   Laugh out loud at you
lolarotf  -   laughing out loud and rolling on the floor
lolaw  -   laugh out loud at work
lolbs  -   laugh out loud but seriously
lolcano  -   laugh out loud
lolci  -   laughing out loud, crying inside
lolcity  -   the whole city laughs out loud
lold  -   laughed out loud
lolees  -   laugh out loud
lolerz  -   laugh out loud
lolf  -   lots of love forever
lolin  -   laughing out loud
lolio  -   laugh out loud I own
lollam  -   Laughing Out Loud Like A Maniac
lollercaust  -   an extreme event of hilarity
lollercoaster  -   laugh out loud (a lot)
lollerskates  -   laughing out loud
lolm  -   laugh out loud
loln  -   laught out loud... not
lolngs  -   laghing out loud never gonna stop
lolocost  -   laugh out loud
lolol  -   laughing out loud
lololz  -   laugh out loud
lolpimp  -   Laughing out loud peeing in my pants
lolq  -   laugh out loud quietly
lolrof  -   laugh out loud
lolrotf  -   laughing out loud rolling on the floor
lols  -   laughing out loud 
lolvq  -   laugh out loud very quietly
lolwtime  -   laughing out loud with tears in my eyes
lolz  -   laughing out loud
lollzz  -  - laugh out loud
lomg  -   like oh my god
loml  -   love of my life
lomy  -   love of my life
lookin  -   looking
loomm  -   laughing out of my mind
lorl  -   laugh out real loud
lorrl  -   laugh out really really loud
lotf  -   laughing on the floor
loti  -   laughing on the inside
loto  -   laughing on the outside
lotr  -   lord of the rings
lov  -   love
lovu  -   love you
loxen  -   laughing out loud
loxxen  -   laughing out loud
lozer  -   loser
lpb  -   low ping bastard
lpiaw  -   Large Penis is always welcome
lpms  -   life pretty much sucks
lq2m  -   laughing quietly to myself
lqtm  -   Laugh quietly to myself
lqtms  -   Laughing quietly to myself
lqts  -   laughing quietly to self
lrfl  -   Laughing really fucking loud
lrqtms  -   laughing really quietly to myself
lsfw  -   Less Safe For Work
lshic  -   laughing so hard i'm crying
lshid  -   laugh so hard i die
lshipmp  -   Laughing so Hard I Piss My Pants
lshismp  -   laughed so hard I shit my pants
lshiwms  -   laughing so hard I wet myself
lshmson  -   laughing so hard milk shot out nose
lshrn  -   laughing so hard right now
lsmih  -   laughing so much it hurts
lsudi  -   Lets see you do it
lthtt  -   laughing too hard to type
ltip  -   laughting until I puke
ltmq  -   Laugh To Myself Quietly
ltms  -   Laughing to my self
ltnc  -   Long time no see
ltns  -   long time no see
ltnsoh  -   Long time, no see or hear
ltnt  -   long time no talk
lttpot  -   laughing to the point of tears
ltywl  -   love the way you lie
lu2d  -   love you to death
lu4l  -   love you for life
lusm  -   love you so much
luv  -   love
luver  -   lover
luvuvm  -   love you very much
luvv  -   love
luzar  -   Loser
lv  -   love
lvl  -   level
lvn  -   loving
lvr  -   lover
lvya  -   love you
lwih  -   look what I have
lyaab  -   Love you as a brother
lyaaf  -   Love you as a friend
lyao  -   laugh your ass off
lybo  -   laugh your butt off
lyf  -   life
lyfao  -   laughing your fucking ass off
lyfe  -   life
lyk  -   like
lyk3  -   like
lyke  -   like
lylab  -   love you like a brother
lylaba  -   love you like a brother always
lylad  -   love you like a dad
lylafklc  -   love you like a fat kid loves cake
lylam  -   love you like a mom
lylas  -   I love you like a sister
lylasa  -   love you like a sister always
lylno  -   Love you like no other
lyls  -   love you lots
lymi  -   love you mean it
lysfm  -   love you so fucking much
lysm  -   love you so much
lyvm  -   love you very much
lzer  -   laser
lzr  -   loser
m  -   am
m$wxp  -   Microsoft Windows XP
m&d  -   mom and dad
m'kay  -   okay
m.i.a  -   Missing In Action
m.o  -   makeout
m/b  -   maybe
m/f  -   male or female
m2  -   me too
m3  -   me
m473s  -   friends
m473z  -   friends
m4f  -   male for female
m4m  -   male for male
m8  -   mate
m84l  -   mate for life
m8s  -   mates
m8t  -   mate
m8t's  -   friends
m9  -   mine
mabby  -   maybe
mabe  -   Maybe
marvy  -   marvelous
masterb8  -   masterbate
mastrb8  -   masturbate.
mayb  -   maybe
mayte  -   mate
mbf  -   must be following
mbfal  -   my best friend and lover
mbhsm  -   My Boobs Hurt So Much
mbl8r  -   Maybe Later
mcds  -   mcdonalds
mcse  -   Microsoft Certified Systems Engineer
meatcurtain  -   woman's private parts
meatspace  -   the real world
meeh  -   me
mego  -   my eyes glaze over
messg  -   message
mf  -   mother fucker
mf2f4sx  -   meet face to face for sex
mfa  -   mother fucking asshole
mfah  -   motherfucking asshole
mfao  -   my fucking ass off
mfb  -   mother fucking bitch
mfg  -   merge from current
mfkr  -   motherfucker
mflfs  -   married female looking for sex
mfr  -   motherfucker
mfw  -   my face when
mgiwjsdchmw  -   my girlfriend is watching jeff so don't call her my wife
mhh  -   my head hurts
mhm  -   Yes
mho  -   My Humble Opinion
mia  -   Missing In Action
mic  -   microphone
miid  -   my internet is down
milf  -   Mom i'd like to fuck
miltf  -   Mom I'd like to fuck
min  -   minute
mins  -   minutes
miq  -   make it quick
mirl  -   meet in real life
misc.  -   miscellaneous
miself  -   myself
mite  -   might
miwnlf  -   mom I would not like to fuck.
mkay  -   ok
mlia  -   my life is amazing
mlod  -   mega laugh out loud of doom
mmamp  -   Meet me at my place
mmas  -   meet me after school
mmatc  -   meet me around the corner
mmatp  -   meet me at the park
mmbocmb  -   message me back or comment me back
mmd  -   make my day
mmiw  -   my mom is watching
mml8r  -   meet me later
mmlfs  -   married man looking for sex
mmmkay  -   okay
mmtyh  -   My mom thinks you're hot
mngmt  -   management
mngr  -   manager
mobo  -   motherboard
mofo  -   mother fucker
mohaa  -   Medal of Honor Allied Assult
mompl  -   moment please
moobs  -   man boobs
mor  -   more
morf  -   male or female
moro  -   tomorrow
moss  -   member of same sex
motarded  -   more retarded
motd  -   message of the day
motos  -   member of the opposite sex
mpaw  -   my parents are watching
mpbis  -   most popular boy in school
mpd  -   Multiple Personality Disorder
mpgis  -   most popular girl in school
mpih  -   my penis is hard
mpty  -   more power to you
mrau  -   message received and understood
msg  -   message
msgs  -   messages
msibo  -   my side is busting open
msie  -   microsoft's internet explorer
msmd  -   monkey see - monkey do
msngr  -   messenger
mssg  -   message
mstrb8r  -   masturbator
mtfbwu  -   may the force be with you
mtfbwy  -   May the Force be with you
mtg  -   Meeting
mtherfker  -   mother fucker
mthrfkr  -   mother fucker
mtrfkr  -   mother fucker
mudda  -   mother
mul  -   miss you lots
musiq  -   music
musm  -   Miss You So Much
mutha  -   mother
muve  -   multi-user virtual environment
muvva  -   mother
muzik  -   music
mwah  -   kiss
mwf  -   Married White Female
mwsmirl  -   maybe we should meet in real life
myaly  -   miss you and love you
myfb  -   mind your fucking business
myke  -   man-dyke
myn  -   mine
myob  -   mind your own business
myodb  -   mind your own damn business
myofb  -   mind your own fucking business
mypl  -   my young padawan learner
mysm  -   Miss you so much
myspce  -   myspace
mmorpg  -   massively multiplayer online role playing game
n  -   and
n e  -   any
n/a/s/l  -   name, age, sex location
n/c  -   no comment
n/m  -   nevermind
n/n  -   nickname
n/o  -   no offense
n/t  -   no text
n00b  -   newbie
n00bs  -   newbies
n00dz  -   nudes
n00s  -   news
n199312  -   african american
n1994  -   african american
n2b  -   not too bad
n2bb  -   nice to be back
n2br  -   not to be rude
n2g  -   Not too good
n2m  -   not too much
n2mh  -   not too much here
n2mhbu  -   not too much how about you?
n2mhjc  -   not too much here just chillin
n2mu  -   not too much, you?
n2n  -   need to know
n2p  -   need to pee
n8v  -   native
na4w  -   not appropriate for work
nade  -   grenade
nafc  -   Not Appropriate for Children
nafkam  -   Not Away From Keyboard Any More
naft  -   Not A fucking Thing
nafta  -   North American Free Trade Agreement
namh  -   not at my house
natch  -   naturally
natm  -   not at the minute
naw-t  -   Naughty
nawidt  -   never again will i do that
nawt  -   not
naww  -   no
nayl  -   in a while
nbdy  -   nobody
ncaa  -   National Collegiate Athletic Association
ncs  -   no crap sherlock
nd  -   and
ndit  -   No details in thread
ne  -   any
ne1  -   anyone
neday  -   any day
nedn  -   any day now
nefing  -   anything
neida  -   any idea
nekkid  -   naked
nemore  -   Anymore
nethin  -   anything
nething  -   anything
neva  -   never
nevah  -   never
nevar  -   Never
nevarz  -   never
nevm  -   never mind
nevr  -   never
newais  -   Anyways
neway  -   anyway
neways  -   anyways
newayz  -   anyways
newb  -   someone who is new
newez  -   anyways
nfbsk  -   not for british school kids
ngaf  -   nobody gives a fuck
nhatm  -   not here at the moment
niggas  -  niggers
ni994  -   nigga
nigga  -  nigger
nifoc  -   naked in front of computer
nifok  -   naked in front of keyboard
nigysob  -   now I've got you son of a bitch
nimby  -   not in my backyard
nips  -   nipples
nite  -   night
nizzle  -   nigger
njoy  -   enjoy
njp  -   nice job partner
nkt  -   never knew that
nld  -   nice lay down
nm u  -   not much, you
nmbr  -   number
nmfp  -   not my fucking problem
nmhau  -   nothing much how about you
nmhm  -   nothing much here, man
nmhu  -   nothing much here, you?
nmhwby  -   nothing much here what about you
nmjb  -   nothing much just bored
nmjc  -   not much, just chillin'
nmjch  -   Nothing Much Just Chilling
nmjcu  -   nothing much, just chilling, you?
nmjdhw  -   nothing much just doing homework
nmjfa  -   nothing much, just fucking around
nmnhnlm  -   no money, no honey, nobody loves me
nmwh  -   no matter what happens
nn2r  -   no need to respond
nnaa  -   no not at all
nnfaa  -   no need for an apology
nntr  -   no need to reply
nntst  -   no need to say thanks
no pro  -   no problem
no1  -   no one
noaa  -   National Oceanic and Atmospheric Administration
noes  -   no
nofi  -   No Flame Intended
nolm  -   No one loves me
nomw  -   not on my watch
noob  -   someone who is new
noobie  -   new person
nooblet  -   new player
noobz0r  -   newbie
noodz  -   nude pictures
nookie  -   sex
norwich  -   knickers off ready when I come home
notin  -   nothing
noty  -   no thank you
noub  -   none of your business
nowai  -   No way
nowin  -   knowing
noyb  -   none of your business
noygdb  -   none of your god damn business
np  -   no problem
np4np  -   naked pic for naked pic
npgf  -   no problem girl friend
npnt  -   no picture, no talk
nr4u  -   not right for you
nrg  -   energy
nrn  -   No Response Necessary
nsas  -   No Strings Attached Sex
nsfmf  -   not so fast my friend
nsfu  -   no sex for you
nsfw  -   not safe for work
nstaafl  -   No Such Thing As a Free Lunch
ntb  -   not to bad
ntbn  -   no text-back needed
nthg  -   nothing
nthin  -   nothing
nthn  -   nothing
ntigaf  -   not that i give a fuck
ntkb  -   need to know basis
ntmk  -   Not to my knowledge
ntmu  -   nice to meet you
ntmy  -   nice to meet you
ntn  -   nothing
ntrly  -   Not Really
ntstt  -   not safe to talk 
ntta  -   nothing to talk about 
nttawwt  -   Not that there is anything wrong with that
nttiawwt  -   Not that there is anything wrong with that.
ntty  -   nice talking to you
ntw  -   not to worry
nty  -   no thank you
nub  -   inexperienced person
nuff  -   enough
nuffin  -   nothing
nufin  -   nothing
nutin  -   nothing
nuttin  -   nothing
nv  -   envy
nvm  -   never mind
nvmd  -   nevermind
nvmdt  -   never mind then
nvmt  -   nevermind that
nvr  -   never
nvrm  -   Nevermind
nvrmnd  -   never mind 
nw  -   no way
nwb  -   a new person
nwih  -   no way in hell
nwj  -   No Way Jose
nwrus  -   no way are your serious 
nws  -   not work safe
nwtf  -   now what the fuck
nxt  -   next
ny1  -   Anyone
nyc  -   New York City
nywy  -   anyway
o rly  -   oh really
o&o  -   over and out
o.p.  -   Original Poster
o/y  -   oh yeah
oaoa  -   over and over again
obgjfioyo  -   old but good job finding it on your own
obv  -   obviously
obvi  -   obviously
ocgg  -   Oh Crap, gotta go
oday  -   software illegally obtained before it was released
odtaa  -   one damn thing after another
oed  -   oxford english dictionary
of10  -   often
ofcol  -   oh for crying out loud
oftc  -   out for the count
oftn  -   often
oftpc  -   off topic
ofwg  -   old fat white guys
oh noes  -   oh shit!
oh noez  -   Oh no!
ohic  -   oh I see
ohnoez  -   Oh no
oibmpc  -   oops I broke my computer
oic  -   oh, I see
oicic  -   oh i see i see
oicu  -   oh, i see you!
oicwydt  -   oh, i see what you did there
oidia  -   oops i did it again
oink  -   Oh I Never Knew
oiyd  -   Only In Your Dreams
ojsu  -   Oh, just shut up!
olpc  -   One Laptop Per Child
omdg  -   oh my dear god
omdz  -   Oh My Days 
omfd  -   oh my fucking days
omfg  -   oh my fucking god
omfgn  -   Oh my fucking god noob
omfgsh  -   Oh My fucking Gosh
omfj  -   oh my fucking jesus
omfl  -   oh my fucking internet connection is slow
omfsm  -   Oh My Flying Spaghetti Monster
omfwtg  -   Oh My fuck What The God?
omg  -   oh my God
omg's  -   oh my god's
omgd  -   Oh my gosh dude
omgf  -   oh my god fuck!
omgg  -   oh my god
omgicfbi  -   Oh my god I can't fucking believe it
omgih  -   Oh My God In Heaven
omgihv2p  -   oh my god i have to pee
omginbd  -   Oh my God, It's no big deal
omgn  -   oh my goodness
omgny  -   oh my god no way
omgosh  -   Oh my gosh
omgroflmao  -   oh my god roll on floor laughing my ass off
omgsh  -   oh my gosh
omgty  -   Oh my god thank you
omgukk  -   oh my god you killed kenny
omgwtf  -   on my God, what the fuck
omgwtfbbq  -   oh my God, what the fuck
omgwtfhax  -   Oh My God What The fuck, Hacks!
omgwtfit  -   Oh my God, what the fuck is that
omgwtfnipples  -   on my God, what the fuck
omgyg2bk  -   oh my god you got to be kidding
omgykkyb  -   oh my god you killed kenny you bastards
omgz  -   oh my God
omgzors  -   oh my god
omhg  -   oh my hell god
omj  -   oh my jesus
ommfg  -   oh my mother fucking god
omt  -   one more time
omw  -   on my way
omwh  -   on my way home
omwts  -   on my way to school
omy  -   oh my!
onoez  -   oh no
onoz  -   oh no
onud  -   oh no you didn't
onyd  -   oh no you didn't
oobl  -   out of breath laughing
oohm  -   out of his/her mind
oomf  -   One of my followers
oomm  -   out of my mind
ootb  -   out of the blue
ootd  -   outfit of the day
ooym  -   out of your mind
orlsx  -   oral sex
orly  -   Oh Really
orly  -   oh really?
orpg  -   online role playing game
osbutctt  -   only sad bastards use this crappy text talk
osifgt  -   oh shit i forgot
oslt  -   or something like that
otfcu  -   on the floor cracking up
otfl  -   on the floor laughing
otflmao  -   On the floor laughing my ass off
otflmfao  -   On the floor laughing my fucking ass off
otflol  -   on the floor laughing out loud
otfp  -   on the fucking phone
otft  -   over the fucking top
otoh  -   on the other hand
otw  -   on the way
outa  -   out of
outta   -   out of
ova  -   over
oways  -   oh wow are you serious
owned  -   made to look bad
ownt  -   made to look bad
ownz  -   owns
ownzer  -   one who makes others look bad
ownzorz  -   Owned.
owt  -   Out
oyfe  -   Open Your fucking Eyes
oyid  -   oh yes i did
p-nis  -   penis
p.o.b.  -   Parent Over Back
p.o.s  -   parent over shoulder
p.o.s.  -   parent over shoulder
p/oed  -   pissed off
p/w  -   password
p00p  -   poop
p0wn  -   make to look bad
p2p  -   peer to peer
p33n  -   penis
p3n0r  -   penis
p3n15  -   penis
p3n1s  -   penis
p4p  -   pic for pic
p911  -   parent emergency (parent near)
pach  -   parents are coming home
pachs  -   parents are coming home soon
parnts  -   parents
pasii  -   put a sock in it
patd  -   Panic At The Disco
pb&j  -   peanut butter and jelly
pbcakb  -   problem between chair and keyboard
pbjt  -   peanut butter jelly time
pbkc  -   Problem between keyboard & chair
pbly  -   probably
pcbd  -   page cannot be displayed
pcent  -   percent
pearoast  -   repost
pebcak  -   Problem Exists Between Chair and Keyboard
pebkac  -   problem exists between keyboard and chair
pebmac  -   Problem Exist Between monitor and chair
peep dis  -   check out what I'm telling you
peeps  -   people
pen0r  -   Penis
pen15  -   penis
penor  -   penis
peoples -   people's
perv  -   pervert
pewp  -   poop
pezzas  -   parents
pfos  -   parental figure over sholder
pg  -   page
ph#  -   phone number
ph33r  -   fear
ph34r  -   fear
phag  -   fag
phail  -   fail
phat  -   pretty hot and tasty
phayl  -   fail
phear  -   fear
phlr  -   peace hugs love respect
phreak  -   freak
phreaker  -   phone hacker
phuck  -   fuck
phucker  -   fucker
phuk  -   fuck
phun  -   fun
phux  -   fuck
phuxor  -   fuck
piab  -   panties in a bunch
pic  -   picture
piccies  -   Pictures
pics  -   pictures
pihb  -   pee in his/her butt
piihb  -   put it in her butt
piitb  -   put it in the butt
pima  -   Pain in my ass
pimfa  -   pain in my fucking ass
pimha  -   Pain in my hairy ass
pimpl  -   pissing in my pants laughing
pino  -   Filipino
pirlos  -   parent in room looking over shoulder
pita  -   pain in the ass
pitfa  -   Pain In The fucking ass
pitr  -   parent in the room
pitrtul  -   parents in the room text you later
pix  -   pictures
pkemon  -   pokemon
pker  -   player killer
pking  -   player killing
pl0x  -   please
pl8  -   plate
plac  -   parent looking at computer
plams  -   parents looking at my screen
plars  -   party like a rock star
platcs  -   parent looking at the computer screen
ple's  -   please
pleaz  -   please
pleez  -   please
pleeze  -   please
pleze  -   please
pliz  -   please
plma  -   please leave me alone 
plmk  -   please let me know
plocks  -   please
plom  -   parents looking over me
plomb  -   parents looking over my back
ploms  -   parent looking over my shoulder
plos  -   Parents Looking Over Shoulder
plox  -   please
pmfji  -   Pardon me for jumping in
pmfsl  -   piss my fucking self laughing
pmita  -   pound me in the ass
pmitap  -   pound me in the ass prison
pmpl  -   piss my pants laughing
pmsfl  -   pissed myself fucking Laughing
pmsl  -   pissing myself laughing
pnbf  -   Potential new boy friend
pnhlgd  -   parents not home, let's get dirty
pns  -   penis
pnus  -   penis
po po  -   police
po'd  -   pissed off
poed  -   pissed off
poets  -   piss off early, tomorrow's Saturday
poidnh  -   Pics or it did not happen 
poms  -   parent over my shoulder
poontang  -   female genitalia
pooter  -   Computer
popo  -   police
poscs  -   parents over sholder change subject
posmbri  -   parent over shoulder might be reading it
potc  -   pirates of the caribbean
pots  -   Plain Old Telephone Service
ppl  -   people
ppls  -   people
pplz  -   people
ppor  -   post proof or recant
ppppppp  -   Prior Proper Planning Prevents Piss Poor Performance
pr0  -   professional
pr0nz  -   porn
prblm  -   Problem
prd  -   period
preggers  -   pregnant
prego  -   Pregnant
prfct  -   perfect
prn  -   porn
prncpl  -   principal
prncss  -   princess
prnoscrn  -   porn on screen
prob  -   problem
probly  -   probably
probz  -   probably
prolly  -   Probably
prollz  -   probably
promos  -   promotions
proxie  -   proxy
prsn  -   person
prty  -   party
prvrt  -   pervert
psbms  -   parent standing by my side
psos  -   parent standing over sholder
pssy  -   pussy
pt33n  -   preteen
ptbb  -   pass the barf bag
ptfo  -   passed the fuck out
pthc  -   preteen hardcore
puh-leaze  -   Please
purty  -   pretty
puter  -   Computer
pwcb  -   parents watching close by
pwd  -   password
pwn  -   made to look bad
pwn3d  -   owned
pwn3r  -   owner
pwnage  -   Ownage
pwnd  -   owned
pwned  -   made to look bad
pwner  -   owner
pwnt  -   owned
pwnz  -   owns
pwnzor  -   owner
pwob  -   Parent watching over back
pwoms  -   parent watching over my shoulder
pwor  -   power
pwos  -   parent was over sholder
pydim  -   put your dick in me
pyfco  -   put your freaking clothes on
pzled  -   puzzled
q33r  -   Queer
qfmft  -   quoted for motherfucking truth
qft&gj  -   quoted for truth and great justice
qltm  -   quietly laughing to myself
qna  -   question and answer
qool  -   cool
qoolz  -   cool
qotd  -   quote of the day
qotsa  -   queens of the stone age
qoty  -   quote of the year
qpwd  -   quit posting while drunk
qt3.14  -   cutie pie
qtpi  -   cutie pie
r  -   are
r-tard  -   retard
r.i.p.  -   rest in peace
r0x0rz  -   rocks
r8  -   rate
r8p  -   rape
r8pist  -   rapist
r8t  -   rate
raoflmao  -   rolling around on floor laughing my ass off
rawk  -   Rock
rawks  -   rocks
rb@u  -   right back at you
rbau  -   right back at you
rbay  -   right back at you
rbtl  -   Read between the lines
rbty  -   right back to you
rcks  -   Rocks
rcsa  -   right click save as
rcvd  -   received
rdy  -   ready
re  -   reply
re/rehi  -   hello again
reefer  -   marijuana
refl  -   rolling on the floor laughing
rehi  -   hello again
rele  -   really
rep  -   represent
reppin  -   representing
retrotextual  -   One who is using out of date words and abbreviations while texting.
rflmao  -   rolling on floor laughing my ass off
rhcp  -   red hot chilli peppers
rhgir  -   really hot guy in room
rhs  -   right hand side
ricl  -   rolling in chair laughing
rifk  -   rolling on the floor laughing
rihad  -   Rot In Hell And Die
rino  -   republican in name only
rite  -   right
ritjive  -   non virgin
rjct  -   reject
rlbf  -   Real Life Boy Friend
rlgf  -   Real Life Girl Friend
rlly  -   really
rly  -   really
rlz  -   rules
rlze  -   realize
rm  -   room
rmso  -   Rock My socks off
rnt  -   aren't
rockr  -   rocker
rofalol  -   roll on the floor and laugh out loud
rofc  -   Rolling On Floor Crying
roffle  -   rolling on the floor laughing
roffle out loud  -   rolling on the floor laughing out loud
rofflecake  -   rolling on the floor laughing
rofflecopters  -   rolling on the floor with laughter
roffleol  -   rolling on the floor laughing out loud
roffles  -   rolling on floor laughing
rofflmfao  -   rolling on the floor laughing my fucking ass
rofl  -   rolling on the floor laughing
rofl&pmp  -   rolling on floor laughing and peeing my pants
roflao  -   rolling on the floor laughing my ass off
roflastc  -   Rolling On Floor Laughing And Scaring The Cat
roflcopter  -   Rolling on the floor laughing
roflcopters  -   rolling on the floor laughing, VERY funny.
roflkmd  -   rolling on the floor laughing kicking my dog
rofllh  -   rolling on the floor laughing like hell
roflmao  -   rolling on the floor laughing my ass off
roflmaoapimp  -   rolling on the floor laughing my ass off and peeing in my pants
roflmaool  -   Rolling on the floor laughing my ass off out loud
roflmaopmp  -   rolling on the floor, laughing my ass off, pissing my pants
roflmaouts  -   Rolling on floor laughing my fucking ass off unable to speak
roflmaowpimp  -   rolling on floor laughing my ass off while peeing in my pants
roflmbfao  -   Rolling On Floor Laughing My Big Fat ass Off 
roflmbo  -   rolling on floor laughing my butt off
roflmfaopimp  -   rolling on the floor laughing my fucking ass off pissing in my pants
roflmfaopmp  -   rolling on flor laughing my fucking ass of peeing my pants
roflmgao  -   rolling on the floor laughing my gay ass off
roflmgdao  -   rolling on the floor laughing my god damn ass off
roflmgdmfao  -   roling on floor laughing my god damn mother fucking ass off
roflmgo  -   Rolling On Floor Laughing My Guts Out
roflmho  -   Rolling on the floor laughing my head off
roflmiaha  -   Rolling on the floor laughing myself into a heart attack
roflmmfao  -   rolling on the floor laughing my mother fucking ass off
roflol  -   rolling on floor laughing out loud
roflolbag  -   Rolling On The Floor Laughing Out Loud Busting A Gut
roflpimp  -   rolling on the floor laughing pissing in my pants
roflpmp  -   rolling on the floor laughing peeing my pants
roflwtime  -   Rolling on the Floor laughing with tears in my eyes
rofpml  -   rolling on the floor pissing myself laughing
rofwl  -   Rolling on the floor while laughing
roglmfao  -   rolling on ground laughing my fucking ass off
roids  -   steroids
rolmao  -   Rolling Over Laughing My ass Off
rolmfao  -   rolling over laughing my fucking ass off
rombl  -   rolled off my bed laughing
rong  -   wrong
roofles  -   rolling on the floor laughing
rotf  -   rolling on the floor
rotfalol  -   roll on the floor and laugh out loud
rotffl  -   roll on the fucking floor laughing
rotfflmao  -   rolling on the fucking floor laughing my ass off
rotfflmfao  -   rolling on the fucking floor laughing my fucking ass off
rotfl  -   rolling on the floor laughing
rotflaviab  -   rolling on the floor laughing and vomiting in a bucket
rotflmao  -   rolling on the floor laughing my ass off
rotflmaofaktd  -   Rolling on the floor laughing my ass off farted and killed the dog
rotflmaool  -   rolling on the floor laughing my ass off out loud
rotflmaostc  -   rolling on the floor laughing my ass off scaring the cat
rotflmbo  -   rolling on the floor laughing my butt off
rotflmfao  -   rolling on the floor laughing my fucking ass off
rotflmfaopimp  -   rolling on the floor laughing my fucking ass off peeing in my pants
rotflmfaopmp  -   rolling on the floor laughing my ass off pissin my pants
rotflmfho  -   rolling on the floor laughing my fucking head off
rotflmho  -   rolling on the floor laughing my head off
rotflmmfao  -   rolling on the floor laughing my mother fucking ass off
rotflol  -   rolling on the floor laughing out loud
rotfpm  -   rolling on the floor pissing myself
rotfwlmao  -   rolling on the floor while laughing my ass off
rotg  -   rolling on the ground
rotgl  -   roll on the ground laughing
rotglmao  -   rolling on the ground laughing my ass off
rotw  -   rest of the world
rowyco  -   rock out with your cock out
rox  -   rocks
roxor  -   rock
roxorz  -   rocks
roxxor  -   rock
rpg  -   role playing game
rpita  -   royal pain in the ass
rplbk  -   reply back
rspct  -   respect
rsps  -   Runescape Private Server
rtard  -   retard
rtbq  -   Read The Blinking Question
rtfa  -   read the fucking article
rtffp  -   Read the fucking front page
rtfm  -   read the fucking manual
rtfmfm  -   read the fucking manual fucking moron
rtfmm  -   read the fucking manual moron
rtfms  -   Read The fucking Manual Stupid
rtfp  -   read the fucking post
rtfq  -   Read The fucking Question
rtfs  -   read the fucking summary
rtfu  -   Ready the fuck up
rtry  -   retry
rts  -   Real-time strategy
ru18  -   are you 18
rua  -   are you alone
ruabog  -   are you a boy or girl
ruagoab  -   are you a girl or a boy
rubz2nt  -   are you busy tonight
rufkm  -   are you fucking kidding me
rugay  -   are you gay
rugta  -   are you going to answer
rukm  -   are you kidding me
rumf  -   Are you male or female
ruok  -   are you ok?
ruwm  -   are you watching me
ryt  -   right
ryte  -   right
*s*  -   smile
s'ok  -   it's okay
s'pose  -   suppose
s'up  -   what is up
s.i.n.g.l.e  -   Stay intoxicated nightly, get laid everyday.
s.i.t.  -   stay in touch
s.o.a.b.  -   son of a bitch
s.o.b.  -   son of a bitch
s.w.a.k.  -   sealed with a kiss
s/b  -   should be
s2a  -   sent to all
s2bu  -   Sucks to be you
s2r  -   send to receive
s2u  -   same to you
s2us  -   Speak to you soon
s3x  -   Sex.
s4se  -   Sight For Sore Eyes
s8ter  -   skater
sagn  -   Spelling and Grammar Nazi
sahm  -   stay at home mom
sase  -   self addressed stamped envelope
sbcg4ap  -   strongbads cool game for attractive people
sblai  -   stop babbaling like an idiot
sbrd  -   so bored
scnr  -   sorry, I couldn't resist
scool  -   school
scrilla  -   money
scrt  -   secret
scurred  -   scared
sdf^  -   shut da fuck up
sdlc  -   Software Development Life Cycle
sec  -   second
secks  -   sex
secksea  -   Sexy
secksy  -   sexy
sed  -   said
seks  -   sex
sellin  -   selling
serp  -   search engine results page
sexc  -   sexy
sexe  -   sexy
sexi  -   Sexy
sexii  -   sexy
sexilicious  -   Very Sexy
sexx0rz  -   sex
sez  -   says
sfam  -   Sister from another mother
sfe  -   safe
sfipmp  -   so funny I peed my pants
sfsg  -   So far so good
sfwuz  -   safe for work until zoomed
sgbadq  -   Search google before asking dumb questions
sgi  -   Still got it
sgtm  -   slightly gigling to myself
shd  -   should
shexi  -   sexy
shexy  -   sexy
shiat  -   shit
shiet  -   shit
shite  -   shit
shiz  -   shit
shizit  -   shit
shiznat  -   shit
shiznit  -   shit
shizz  -   shit
shizzle  -   shit
shld  -   should
shmexy  -   sexy
shmily  -   see how much i love you
sho  -   sure
sho'nuff  -   sure enough
showin  -   showing
shrn  -   so hot right now
sht  -   shit
shtf  -   shit hits the fan
shud  -   should
shuddup  -   Shut Up
shup  -   shut up
shure  -   sure
shut^  -   shut Up
shwr  -   shower
shyat  -   shit
shyt  -   shit
siao  -   school is almost over
sibir  -   sibling in room
sicl  -   sitting in chair laughing
sifn't  -   as if not
siggy  -   Signature
silf  -   Sister I'd Like To fuck
simcl  -   sitting in my chair laughing
simclmao  -   sitting in my chair laughing my ass off
siol  -   Shout It Out Loud
sis  -   sister
sista  -   Sister
sitb  -   sex in the but
sitmf  -   say it to my face
siuya  -   shove it up your ass
sk8er  -   skater
sk8ing  -   Skating
sk8r  -   skater
sk8ter  -   skater
sk8tr  -   skater
sked  -   schedule
skeet  -   ejaculate
skewl  -   school
skhool  -   school
skillz  -   skills
skl  -   School
skool  -   school
skoul  -   school
sktr  -   skater
skwl  -   school
sl4n  -   so long for now
sleepin  -   sleeping
sleepn  -   sleeping
slgb  -   Straight/Lesbian/Gay/Bisexual
slng  -   slang
slore  -   shitty whore
slos  -   someone looking over shoulder
smbt  -   Suck my big toe
smdb  -   suck my dick bitch
smdvq  -   suck my dick quickly
smeg  -   fuck
smexy  -   sexy
smfd  -   suck my fucking dick
smfpos  -   stupid mother fucking piece of shit
smhb  -   suck my hairy balls
smho  -   Screaming My Head Off
smithwaws  -   Smack me in the head with a wooden spoon
smofo  -   stupid mother fucker
smst  -   somebody missed snack time
smthin  -   something
smthng  -   something
smtm  -   sometime
smto  -   Sticking My Tongue Out
smtoay  -   Sticking my tongue out at you
snafu  -   situation normal all fucked up
snafubar  -   Situation Normal All fucked Up Beyond Any Recognition
snes  -   Super Nintendo Entertainment System
snew  -   what's new
snog  -   kiss
snogged  -   kissed
soab  -   son of a btch
soad  -   system of a down
soafb  -   son of a fucking bitch
sobs  -   same, old, boring shit
sofas  -   stepping out for a smoke
sofs  -   same old fucking shit
sokay  -   it's okay
som'm  -   something
som1  -   someone
somadn  -   sitting on my ass doing nothing
some1  -   someone
soml  -   story of my life
soobs  -   saggy boobs
sool  -   shit out of luck
sorg  -   Straight or Gay
sorreh  -   sorry
sorta  -   sort of
sosdd  -   same old shit, different day
sosg  -   spouse over shoulder gone
sotc  -   stupid off topic crap
sotr  -   sex on the road
sowi  -   sorry
sowwy  -   sorry
sploits  -   exploits
sploitz  -   exploits
spos  -   stupid peace of shit
sprm  -   sperm
sqtm  -   snickering quietly to myself
srch  -   search
srly  -   seriously
sroucks  -   that's cool, but it still sucks
srry  -   sorry
srs  -   serious
srsly  -   seriously
srvis  -   Service
sry  -   sorry
srynd2g  -   sorry need to go
srzly  -   seriously
ss4l  -   smoking sista for life
ssdd  -   same shit, different day
ssdp  -   same shit different pile
ssia  -   subject says it all
ssob  -   stupid sons of bitches
ssry  -   so sorry
sssd  -   Same shit Same Day
stbx  -   soon to be ex
stby  -   sucks to be you
std  -   sexually transmitted disease
steamloller  -   Laughing. Alot.
stfd  -   sit the fuck down
stff  -   stuff
stfm  -   search the fucking manual
stfng  -   search the fucking news group
stfu  -   shut the fuck up
stfua  -   shut the fuck up already
stfuah  -   shut the fuck up asshole
stfub  -   shut the fuck up bitch
stfuda  -   Shut the fuck up dumb ass
stfugbtw  -   shut the fuck up and get back to work
stfun  -   Shut the fuck up nigger
stfuogtfo  -   Shut the fuck up or get the fuck out.
stfuppercut  -   shut the fuck up
stfuyb  -   shut the fuck up you bitch
stfuysoab  -   shut the fuck up you son of a bitch
stfw  -   search the fucking web
sth  -   something
sthing  -   something
sthu  -   shut the hell up
stoopid  -   stupid
stpd  -   stupid
str8  -   straight
str8up  -   straight up
sts  -   so to speak
stsp  -   Same Time Same Place
stt  -   Same time tomorrow
stufu  -   stupid fucker
stupd  -   stupid
stw  -   share the wealth 
stys  -   speak to you soon
suabq  -   shut up and be quiet
suagooml  -   shut up and get out of my life
suib  -   shut up im busy
suk  -   suck
suka  -   Sucker
sukz  -   sucks
sum1  -   someone
sumfin  -   Something
summin  -   something
sumone  -   someone
sumthin'  -   Something
sumtin  -   something
sup  -   what's up
supa  -   super
supposably  -   Supposedly
susfu  -   situation unchanged, still fucked up
sutuct  -   so you think you can type
sux  -   sucks
sux0rz  -   sucks
sux2bu  -   sucks to be you
suxor  -   Sucks
suxors  -   sucks
suxorz  -   sucks
suxx  -   sucks
suxxor  -   sucks
suyah  -   shut up you ass hole!
swafk  -   sealed with a friendly kiss
swak  -   sealed with a kiss
swakaah  -   Sealed With A Kiss And A Hug
swalk  -   sealed with a loving kiss
swmbo  -   she who must be obeyed
swmt  -   Stop Wasting My Time 
swsw2b  -   single when she wants to be
swtf  -   seriously, what the fuck
sx  -   sex
sxc  -   sexy
sxcy  -   sexy
sxy  -   sexy
syatp  -   see you at the party
sydim  -   stick your dick in me
sydlm  -   Shut your dirty little mouth
syfm  -   shut your fucking mouth
syiab  -   see you in a bit
syiaf  -   see you in a few
syl8r  -   see you later
syoa  -   Save Your Own ass
syotbf  -   see you on the battlefield
syrs  -   see ya real soon
sysop  -   system operator
sytycd  -   so you think you can dance 
t#3  -   the
t,ftfy  -   there, fixed that for you
t.t.y.l  -   Talk To You Later
t/a  -   Try again
t2ul  -   talk to you later
t2ul8r  -   talk to you later
t3h  -   the
t8st  -   taste
taci  -   that's a crappy idea
tafn  -   That's all for now
taht  -   that
taig  -   That's all I got. 
tanq  -   thank you
tanstaafl  -   there ain't no such thing as a free lunch
tard  -   retard
tarfu  -   things are really f**ked up
tat2  -   tattoo
taunch  -   te amo un chingo
tb4u  -   too bad for you
tba  -   to be anounced
tbc  -   To be continued
tbd  -   to be decided
tbf  -   to be fair
tbfh  -   to be f**king honest
tbfu  -   too bad for you
tbh  -   to be honest
tbhimo  -   to be honest in my opinion
tbnt  -   thanks but no thanks
tbp  -   The Pirate Bay
tbpfh  -   To be perfectly f**king honest
tbph  -   To be perfectly honest
tbqf  -   to be quite frank
tbqh  -   to be quite honest
tbss  -   too bad so sad
tbtfh  -   to be totally freaking honest
tbvh  -   to be very honest
tc  -   take care
tcfc  -   Too Close For Comfort
tcfm  -   too cool for me
tchbo  -   Topic creater has been owned
tcial  -   The cake is a lie
tcoy  -   take care of yourself
td2m  -   talk dirty to me
tddup  -   till death do us part
tdtm  -   Talk Dirty To Me
tdwdtg  -   The Devil Went Down To Georgia
teh  -   the
teotwawki  -   the end of the world as we know it
tfbundy  -   totaly f**ked but unfortunatly not dead yet
tfft  -   thank f**k for that
tffw  -   Too funny for words
tfic  -   Tongue Firmly In Cheek
tfiik  -   the f**k if i know
tfln  -   thanx for last night
tfta  -   thanks for the add
tfti  -   thanks for the information
tfu2baw  -   time for you to buy a watch
tgfe  -   together forever
tgfitw  -   The Greatest Fans In The World
tgft  -   thank god for that
tgfu  -   too good for you
tgfuap  -   thank god for unanswered prayers
tghig  -   thank god husband is gone
tgif  -   thank god it's friday
tgiff  -   thank god its f**king Friday
tgis  -   thank god it's saturday
tgiwjo  -   Thank God It Was Just Once
tgsttttptct  -   thank God someone took the time to put this crap together
tgtbt  -   Too Good To Be True
tgwig  -   thank god wife is gone
tgws  -   that goes without saying
th@  -   that
tha  -   the
thankies  -   Thank You
thankx  -   thanks
thanq  -   thank you
thanx  -   thank you
thar  -   there
thatz  -   that's
thku  -   thank you
thn  -   then
thnk  -   think
thnx  -   thanks
thot  -   the hoe of today
thr  -   there
thr4  -   therefore
thru  -   through
tht  -   that
thwdi  -   thats how we do it
thwy  -   the hell with you!
thx  -   thanks
thankx - thanks
thxx  -   thanks
thz  -   thanks
ti2o  -   that is too obious
tiafayh  -   Thanks in advance for all your help
tiai  -   take it all in
tias  -   Try It And See
tiatwtcc  -   this is a trap word to catch copiers
tif2m  -   this is f**king 2 much
tifs  -   this is funny s**t
tifu  -   that is f**ked up
tigger  -   tiger
tiic  -   the idiots in control
tilf  -   Teenager I'd Like To f**k
tinf  -   this is not fair
tinla  -   this is not legal advice
tinstaafl  -   There Is No Such Thing As A Free Lunch
tioli  -   take it or leave it
tisc  -   that is so cool
tisfu  -   that is so f**ked up
tisg  -   this is so gay
tisly  -   that is so last year
tisnf  -   that is so not fair
tiss  -   This is some s**t
tisw  -   that is so wrong
tix  -   ticket
tk2ul  -   talk to you later
tl8r  -   talk later
tla  -   Three Letter Acronym
tldnr  -   too long, did not read
tldr  -   Too long, didn't read.
tlgo  -   The list goes on
tliwwv  -   this link is worthless without video
tlk  -   talk
tlk2me  -   talk to me
tlk2ul8r  -   talk to you later
tlkin  -   talking
tlkn  -   talking
tltpr  -   Too long to proof read.
tlyk  -   to let you know
tmaai  -   tell me all about it
tmai  -   tell me about it
tmbi  -   tell me about it
tmi  -   too much information
tmk  -   to my knowledge
tmmrw  -   tomorrow
tmnt  -   teenage mutant ninja turtles
tmoro  -   tomorrow
tmoz  -   tomorrow
tmr  -   tomorrow
tmr@ia  -   the monkeys are at it again
tmrrw  -   tomorrow
tmrw  -   Tomorrow
tmrz  -   tomorrow
tmsaisti  -   That's my story and I'm sticking to it.
tmsg  -   tell me something good
tmsidk  -   tell me somthing I don't know
tmth  -   too much to handle
tmtmo  -   text me tomorrow
tmtoyh  -   Too Much Time On Your Hands
tmtt  -   tell me the truth
tmwfi  -   Take my word for it
tmz  -   tomorrow
tn1  -   trust no-one
tna  -   tits and a**
tnf  -   That's Not Funny
tnlnsl  -   Took nothing left nothing signed log
tnx  -   thanks
tnxz  -   thanks
tofy  -   Thinking of You
tok2ul8r  -   i'll talk to you later
tolol  -   thinking of laughing out loud
tomm  -   tommorow
tomoz  -   tomorrow
totes  -   totally
totl  -   total
totm  -   top of the morning
totpd  -   top of the page dance
toya  -   thinking of you always
tpiwwp  -   this post is worthless without pictures
tptb  -   the powers that be
trani  -   transexual
tranny  -   Transexual
trble  -   trouble
trnsl8  -   translate
trnsltr  -   translator
tru  -   true
tsc  -   that's so cool
tsff  -   thats so f**kin funny
tsig  -   that site is gay
tsnf  -   that's so not fair
tstoac  -   too stupid to own a computer
tswc  -   tell someone who cares
tt4n  -   ta ta for now
ttbc  -   Try to be cool
ttbomk  -   to the best o fmy knowledge
ttfaf  -   Through the Fire and Flames
ttfn  -   ta ta for now
tthb  -   try to hurry back
ttihlic  -   try to imagine how little i care
ttiuwiop  -   this thread is useless without pics
ttiuwop  -   this thread is useless without pics
ttiuwp  -   This Thread Is Useless Without Pictures
ttiwwop  -   This thread is worthless without pics
ttiwwp  -   this thread is worthless without pics
ttl  -   total
ttlly  -   totally
ttly  -   totally
ttml  -   talk to me later
ttms  -   talking to myself
ttrf  -   That's the rules, f**ker
ttul8r  -   Talk to you later
ttus  -   talk to you soon
ttut  -   Talk to you Tomorrow
ttutt  -   to tell you the truth
tty  -   Talk to You
ttyab  -   Talk to you after breakfast
ttyad  -   Talk to you after Dinner
ttyal  -   Talk to you after lunch
ttyas  -   talk to you at school
ttyiam  -   talk to you in a minute
ttyitm  -   talk to you in the morning
ttyl  -   talk to you later
ttyl8r  -   talk to you later
ttylo  -   talk to you later on
ttylt  -   talk to you later today
ttyn  -   talk to you never
ttyna  -   talk to you never again
ttynl  -   talk to you never loser
ttynw  -   talk to you next week
ttyo  -   talk to you online
ttyob  -   tend to your own business
ttyotp  -   talk to you on the phone
ttyrs  -   talk to you really soon
ttys  -   talk to you soon
ttyt  -   talk to you tomorrow
ttytm  -   talk to you tomorrow
ttytt  -   to tell you the truth
ttyw  -   talk to you whenever
ttywl  -   Talk to you way later
tuff  -   tough
twajs  -   That was a joke, son.
twat  -   vagina
twbc  -   that would be cool
twdah  -   that was dumb as hell
twfaf  -   thats what friends are for
twis  -   that's what I said
twoh  -   typing with one hand
tws2wa  -   That was so 2 weeks ago
twss  -   That's what she said
twsy  -   That was so yeterday
twttr  -   twitter
twvsoy  -   that was very stupid of you
twyl  -   Talk With You Later
twys  -   Talk With You Soon
txt  -   text
txting  -   texting
txtyl  -   text you later
tyclos  -   turn your CAPS LOCK off, stupid
tyfi  -   Thank You for invite
tyfn  -   thank you for nothing
tyfyc  -   Thank You For Your Comment
tyfyt  -   Thank you for your time
tyl  -   text you later
tym  -   time
tyme  -   time
tyred  -   tired
tys  -   Told You So
tysfm  -   thank you so f**king much
tysm  -   thank you so much
tysvm  -   thank you so very much
tyto  -   take your top off
tyty  -   thank you thank you
tyvm  -   Thank You Very Much
tyvvm  -   thank you very very much
tho  -   though
tbh  -   to be honest
theyre  -  they're
tryna  -  trying to
tha  -   the
trynna  -   trying to
thats  -   that's
tht -  that
u  -   you
u iz a 304  -   you is a hoe
u'd  -   you would
u'll  -   you will
u'r  -   you're
u'v  -   you have
u've  -   You've
u/l  -   upload
u/n  -   username
u2  -   You too
uaaaa  -   Universal Association Against Acronym Abuse
uayor  -   Use At Your Own Risk
ub3r  -   super
uctaodnt  -   you can't teach an old dog new tricks
udek  -   you don't even know
udwk  -   you don't want to know
ufab  -   ugly fat ass bitch
ufia  -   unsolicited finger in the anus
ufic  -   Unsolicited Finger in Chili
ufmf  -   you funny mother fucker
ufr  -   Upon further review
ugba  -   you gay bitch ass
ugtr  -   you got that right
uhab  -   you have a blog
uhems  -   you hardly ever make sense
ujds  -   u just did shit
ukwim  -   you know what i mean
ulbom  -   you looked better on myspace
umfriend  -   sexual partner
un2bo  -   you need to back off
un4rtun8ly  -   unfortunately
upcia  -   unsolicited pool cue in anus
upia  -   unsolicited pencil in anus
upmo  -   You piss me off
upos  -   you piece of shit
ur  -   your
ur2g  -   you are too good
ur6c  -   you're sexy
ura  -   you are a
uradrk  -   you're a dork
urafb  -   you are a fucking bitch
uraqt  -   you are a cutie
urcrzy  -   you are crazy
ure  -   you are
urht  -   you're hot
url8  -   you are late
urms  -   you rock my socks
urmw  -   you are my world
urnc  -   you are not cool
urs  -   yours
ursab  -   you are such a bitch
ursdf  -   you are so damn fine
ursg  -   you are so gay
ursh  -   you are so hot
urssb  -   you are so sexy baby
urstpid  -   you are stupid
urstu  -   you are stupid
urtb  -   you are the best
urtbitw  -   You are the best in the world!
urtrd  -   you retard
urtw  -   you are the worst
uryyfm  -   you are too wise for me
usck  -   you suck
ussr  -   The Union of Soviet Socialist Republics
usuk  -   You Suck
usux  -   you suck
utfs  -   Use the fucking search
utfse  -   use the fucking search engine
uttm  -   you talking to me?
utube  -   youtube
uve  -   You've
uvgtbsm  -   you have got to be shiting me
uyab  -   up your ass bitch
v4g1n4  -   vagina
vag  -   vagina
vajayjay  -   vagina
vbeg  -   very big evil grin
vid  -   video
vids  -   videos
voip  -   voice over ip
vrsty  -   Varsity
vry  -   very
vzit  -   visit
vzn  -   verizon
w'sup  -   what's up
whatz  - what is
w.e  -   Whatever
w.e.  -   whatever
w.o.w  -   World of Warcraft
w.o.w.  -   world of warcraft
w/b  -   write back
w/e  -   whatever
w/end  -   weekend
w/eva  -   whatever
w/o  -   with out
w/out  -   without
w/u  -   with you
w00t  -   woohoo
w012d  -   word
w2ho  -   want to hang out
w33d  -   weed
w8  -   wait
w8am  -   wait a minute
w8ing  -   waiting
w8t4me  -   wait for me
w8ter  -   waiter
w911  -   Wife in room
wadr  -   with all due respect
wadzup  -   What's up?
wafda  -   What a fucking Dumb ass
wafl  -   what a fucking loser
wafm  -   wait a fucking minute
wafn  -   what a fucken noob
waloc  -   what a load of crap
walstib  -   what a long strange trip it's been
wamh  -   with all my heart
wan2tlk  -   Want to talk
wana  -   want to
wanafuk  -   wanna fuck
wanker  -   masturbater
wanking  -   Masturbating
wansta  -   wanna be ganster
warez  -   illegally obtained software
wassup  -   what's up?
wasup  -   What's Up
wat  -   what
watcha  -   what you
watev  -   whatever
wateva  -   whatever 
watevr  -   whatever
watevs  -   whatever
wats  -   whats
wats^  -   what's up?
watz ^  -   What's up
waug  -   Where are you going
wauw  -   what are you wearing
waycb  -   when are you coming back
wayd  -   what are you doing
waygow  -   who are you going out with
wayh  -   why are you here
wayn  -   Where Are You Now
waysttm  -   why are you still talking to me
waysw  -   Why are you so weird
wayt  -   What are you thinking?
wayta  -   what are you talking about
wayut  -   what are you up to
wassup   -   what's up
wazz  -   what's
wazza  -   what's up
wazzup  -   what's up
waz^  -   what's up?
wb  -   welcome back
wbagnfarb  -   would be a good name for a rock band
wdidn  -   what do i do now
wdim  -   What Did I miss
wdtm  -   what does that mean
wduc  -   what do you care
wdum  -   what do you mean
wdus  -   What Did You Say
wdut  -   what do you think?
wdutom  -   what do you think of me
wduw  -   what do you want
wduwta  -   what do you wanna talk about
wduwtta  -   what do you want to talk about
wdwdn  -   what do we do now
wdwgw  -   where did we go wrong
wdydt  -   why do you do that
wdye  -   What do you expect
wdyl  -   who do you like
wdym  -   what do you mean
wdys  -   What did you say
wdyt  -   what do you think
wdytia  -   who do you think i am?
wdyw  -   what do you want
wdywd  -   what do you want to do?
wdywtd  -   what do you want to do
wdywtdt  -   Why Do You Want To Do That?
wdywtta  -   what do you want to talk about
webby  -   webcam
welc  -   welcome
wen  -   when
werkz  -   works
weve  -   what ever
wevr  -   whatever
wfhw  -   what's for homework
wfyb  -   whatever floats your boat
wgac  -   who gives a crap
wgaf  -   Who gives a fuck
wgas  -   who gives a shit
wgasa  -   who gives a shit anyway
wgph2  -   Want to go play Halo 2?
wha  -   what?
whaddya  -   what do you
whaletail  -   thong
whatcha  -   what are you
whatev  -   whatever
whatevs  -   whatever
whats ^  -   whats up
what^  -   what's up?
whenevs  -   whenever
whevah  -   where ever
whever  -   whatever
whit  -   with
whodi  -   friend
whr  -   where
whs  -   wanna have sex
wht  -   What
whteva  -   what ever
whteve  -   whatever
whtever  -   whatever
whtevr  -   whatever
whtvr  -   whatever
wht^  -   what up
whubu2  -   what have you been up to
whubut  -   what have you been up to
whut  -   what
whyb  -   where have you been
whyd  -   What Have You Done
wid  -   with
widout  -   without
wieu2  -   What Is Everyone Up To
wif  -   With
wiid  -   what if i did
wilco  -   will comply
winnar  -   winner
witcha  -   with you
witfp  -   What is the fucking point
witwct  -   What is the world coming too
witwu  -   who is there with you
witwwyt  -   what in the world were you thinking
wiuwu  -   what is up with you
wiwhu  -   wish I was holding you
wiwt  -   wish i was there 
wiyp  -   what is your problem
wjwd  -   What Jesus Would Do
wk  -   week
wkd  -   wicked
wkend  -   weekend
wl  -   will
wlc  -   welcome
wlcb  -   welcome back
wlcm  -   welcome
wld  -   would
wlkd  -   walked
wlos  -   wife looking over Shoulder
wltm  -   would like to meet
wmao  -   working my ass off
wmd  -   Weapons Of Mass Destruction
wmgl  -   wish me good luck
wmyb  -   What Makes You Beautiful
wna  -   want to
wnkr  -   wanker
wnrn  -   why not right now
wnt  -   want
wntd  -   what not to do
wochit  -   watch it
woft  -   Waste of fucking time
wogge  -   what on god's green earth?
wogs  -   waste of good sperm
wolo  -   we only live once
wombat  -   waste of money, brains, and time
wot  -   what
wotevs  -   whatever
wotv  -   What's on Television?
wotw  -   word of the week
woum  -   what's on your mind
wowzers  -   wow
woz  -   was
wrd  -   word
wrdo  -   weirdo
wrgad  -   who really gives a damn
wrgaf  -   Who really gives a fuck?
wrk  -   work
wrm  -   which reminds me
wrng  -   wrong
wrtg  -   writing
wrthls  -   Worthless
wrud  -   what are you doing
wruf  -   where are you from
wruu2  -   what are you up to
wshtf  -   when shit hits the fan
wsibt  -   when should i be there
wsidi  -   Why Should I Do It
wsop  -   world series of poker
wswta  -   What shall we talk about?
wtbd  -   what's the big deal
wtbh  -   What the bloody hell
wtcf  -   what the crazy fuck
wtf  -   what the fuck
wtfaud  -   what the fuck are you doing?
wtfay  -   who the fuck are you
wtfayd  -   what the fuck are you doing
wtfayt  -   why the fuck are you talking
wtfayta  -   What the fuck are you talking about?
wtfb  -   what the fuck bitch
wtfbs  -   What the fuck bull shit
wtfc  -   Who The fuck Cares
wtfdik  -   what the fuck do i know
wtfdum  -   what the fuck do you mean
wtfduw  -   What the fuck do you want?
wtfdyw  -   what the fuck do you want
wtfe  -   What The fuck Ever
wtfever  -   what the fuck ever
wtfg  -   What the fucking god
wtfh  -   what the fucking hell
wtfhb  -   what the fucking hell bitch
wtfhwt  -   what the fucking hell was that
wtfigo  -   what the fuck is going on
wtfigoh  -   what the fuck is going on here
wtfit  -   what the fuck is that
wtfits  -   what the fuck is this shit
wtfiu  -   what the fuck is up
wtfiup  -   what the fuck is your problem
wtfiuwy  -   what the fuck is up with you
wtfiwwu  -   what the fuck is wrong with you
wtfiwwy  -   what the fuck is wrong with you
wtfiyp  -   what the fuck is your problem
wtfm  -   what the fuck, mate?
wtfmf  -   what the fuck mother fucker
wtfo  -   what the fuck over
wtfru  -   what the fuck are you
wtfrud  -   What the fuck are you doing?
wtfrudng  -   what the fuck are you doing
wtfrudoin  -   what the fuck are you doing
wtfruo  -   what the fuck are you on?
wtfruttd  -   what the fuck are you trying to do
wtfs  -   what the fucking shit?
wtfuah  -   what the fuck you asshole
wtful  -   What the fuck you loser
wtfwjd  -   what the fuck would jesus do
wtfwt  -   what the fuck was that
wtfwtd  -   what the fuck was that dude
wtfwtf  -   what the fuck was that for?
wtfya  -   what the fuck you asshole
wtfyb  -   what the fuck you bitch
wtgds  -   way to go dumb shit
wtgp  -   Want to go Private
wtharud  -   what the hellare you doing
wthau  -   who the hell are you
wthauwf  -   what the hell are you waiting for
wthay  -   who the hell are you
wthayd  -   what the heck are you doing
wthaydwmgf  -   what the hell are you doing with my girlfriend
wthdydt  -   why the hell did you do that
wthhyb  -   where the hell have you been?
wthigo  -   what the hell is going on
wthiwwu  -   What the hell is wrong with you
wtho  -   want to hang out?
wthru  -   Who the heck are you
wthrud  -   what the hell are you doing?
wths  -   want to have sex
wthswm  -   want to have sex with me
wthwt  -   what the hell was that?
wthwut  -   what the hell were you thinking
wthyi  -   what the hell you idiot
wtii  -   what time is it
wtiiot  -   What time is it over there?
wtityb  -   whatever, tell it to your blog
wtly  -   Welcome to last year
wtmf  -   what the mother fuck
wtmfh  -   what the mother fucking hell
wtmi  -   way too much information
wtmtr  -   what's the matter
wtrud  -   what are you doing
wttp  -   want to trade pictures?
wtva  -   whatever
wtvr  -   whatever
wtwm  -   what time are we meeting?
wtwr  -   well that was random
wu2kilu  -   want you to know I love you
wubmgf  -   Will You Be My Girlfriend?
wubu2  -   what you been up to
wubut  -   what you been up too
wud  -   would
wudev  -   Whatever
wudn  -   what you doing now
wugowm  -   will you go out with me
wula  -   what you looking at?
wuld  -   would
wuny  -   wait until next year
wussup  -   What is up?
wut  -   what
wutb  -   What are you talking about
wutcha  -   What are you
wuteva  -   whatever
wutevr  -   what ever
wuts  -   what is
wutup  -   What's Up
wuu2  -   what you up too
wuu2  -   what you up to
wuu22m  -   what you up to tomorrow
wuut  -   what you up to
wuwh  -   Wish you were here
wuwt  -   what's up with that
wuwta  -   what do you want to talk about
wuwtab  -   what do you want to talk about
wuwtb  -   what do you want to talk about
wuwtta  -   what you want to talk about
wuwu  -   what up with you
wuz  -   was
wuza  -   what's up
wuzup  -   what's up
wwc  -   who would care
wwcnd  -   What would Chuck Norris do
wwdhd  -   What would David Hasselhoff do
wwgf  -   when we gonna fuck
wwhw  -   when where how why
wwikt  -   why would i know that
wwjd  -   what would jesus do?
wwtf  -   what was that for
wwudtm  -   what would you do to me
wwut  -   what were you thinking
wwwy  -   what's wrong with you
wwy  -   where were you
wwycm  -   when will you call me
wwyd  -   what would you do?
wwyd2m  -   what would you do to me
wwyt  -   What were you thinking
wy  -   Why?
wyas  -   wow you are stupid
wyatb  -   wish you all the best
wyauimg  -   Why you all up in my grill?
wybts  -   were you born this sexy
wycm  -   Will You Call Me
wygac  -   when you get a chance
wygam  -   When you get a minute
wygowm  -   Will you go out with me
wygwm  -   will you go with me
wyhi  -   Would You Hit It?
wyhswm  -   would you have sex with me
wyltk  -   wouldn't you like to know
wylym  -   Watch Your Language Young Man
wypsu  -   will you please shut up
wysiayg  -   what you see is all you get
wysitwirl  -   what you see is totally worthless in real life
wysiwyg  -   what you see is what you get
wywh  -   wish you were here
wywo  -   while you were out
xtreme    - extreme
xb36t  -   Xbox 360
xbf  -   ex-boyfriend
xbl  -   xbox live
xcept  -   except
xcpt  -   except
xellent  -   excellent
xfer  -   transfer
xgf  -   exgirlfriend
xing  -   crossing
xit  -   Exit
xl  -   extra large
xlnt  -   Excellent
xmas  -   christmas
xmpl  -   example
xoac  -   Christ on a crutch
xover  -   crossover
xpect  -   expect
xplaned  -   explained
xpt  -   except
xroads  -   crossroads
xtc  -   ecstasy
xtra  -   extra
xtreme  -   extreme
xyz  -   examine your zipper
xyzpdq  -   Examine Your Zipper Pretty Darn Quick
y  -   why
y!a  -   yahoo answers
y/n  -   yes or no
y/o  -   Years Old
y00  -   you
y2b  -   Youtube
y2k  -   year 2000
yaaf  -   you are a fag
yaafm  -   You Are A fucking Moron
yaagf  -   you are a good friend
yaai  -   You are an idiot
yafi  -   you're a fucking idiot
yall  -   y'all
yapa  -   yet another pointless acronym
yaqw  -   You are quite welcome
yarly  -   yeah really
yasan  -   You are such a nerd
yasf  -   you are so funny
yasfg  -   you are so fucking gay
yasg  -   you are so gay
yasw  -   you are so weird
yatb  -   you are the best
yatwl  -   you are the weakest link
yayo  -   cocaine
ybbg  -   Your Brother By Grace
ybya  -   you bet your ass
ycliu  -   You could look it up
ycmtsu  -   You Can't Make This shit Up
ycntu  -   Why Cant You?
yctwuw  -   you can think what you want
ydpos  -   you dumb piece of shit
ydtm  -   You're dead to me
ydufc  -   Why do fucking care?
yduwtk  -   why do you want to know
yea  -   yeah
yer  -   you're
yermom  -   your mother
yesh  -   yes
yew  -   you
ygpm  -   you've got a private message
ygrr  -   you got rick rolled
ygtbfkm  -   you've got to be fucking kidding me
ygtbk  -   you've got to be kidding
ygtbkm  -   you got to be kidding me
ygtbsm  -   You've got to be shitting me
ygtsr  -   you got that shit right
yh  -   yeah
yhbt  -   you've been trolled
yhew  -   you
yhf  -   you have failed
yhgtbsm  -   You Have Got To Be Shitting Me
yhl  -   you have lost
yhm  -   You have mail
yhpm  -   you have a private messge
yhtbt  -   You Had To Be There
yiwtgo  -   Yes, I want to go private
ykisa  -   Your knight in shining armor
ykwim  -   you know what I mean
ykwya  -   you know who you are
ykywywm  -   you know you wish you were me
ymbkm  -   you must be kidding me
ymfp  -   Your Most Favorite Person
ymg2c  -   your mom goes to college
ymgtc  -   Your Mom Goes To college
ymiaw  -   your mom is a whore
ymislidi  -   you make it sound like i did it
ymmd  -   You Made My Day
ymmv  -   your mileage may vary
ymrasu  -   Yes, My Retarded ass Signed Up
yng  -   young
yodo  -   you only die once
yolo  -   you only live once
yolt  -   you only live twice
yomank  -   you owe me a new keyboard
yooh  -   you
yor  -   your
ypmf  -   you pissed me off
ypmo  -   you piss me off
ypom  -   your place or mine
yr  -   year
yrbk  -   Yearbook
yrms  -   You Rock My Socks
yrs  -   years
yrsaf  -   You Are Such A Fool 
yrsm  -   you really scare me
yrss  -   you are so sexy
yrubm  -   why are you bugging me?
yrusm  -   Why are you so mean
ysal  -   you suck at life
ysati  -   you suck at the internet
ysic  -   why should I care
ysitm  -   your shirt is too small
ysoab  -   You son of a bitch
yswnt  -   why sleep when not tired?
ytfwudt  -   why the fuck would you do that?
ythwudt  -   Why the hell would you do that
ytis  -   You think I'm special?
ytmnd  -   You're the man now, dog!
yu  -   You
yuo  -   you
yur  -   your
yust  -   why you say that
yvfw  -   you're very fucking welcome
ywapom  -   you want a piece of me?
ywia  -   You're welcome in advance
ywic  -   why would i care
ywsyls  -   you win some you lose some
ywud  -   yo whats up dude
ywvm  -   you're welcome very much
ywywm  -   you wish you were me
yysw  -   yeah, yeah, sure, whatever
z'omg  -   Oh my God
z0mg  -   oh my god
zex  -   sex
zomfg  -   oh my fucking god
zomg  -   Oh my God
zomgzorrz  -   oh my god
zoot  -   woohoo
zup  -   what's up?
2day    -  today
2gether    -  together
2moro    -  tomorrow
2morrow    -  tomorrow
2moz    -  tomorrow
2nite    -  tonight
4ever    -  forever
4got    -  forgot
4rm    -  from
aa    -  a
aand   -  and
aanndd  - and 
andd  - and
aaaand    -  and
abt    -  about
acct    -  account
actualy    -  actually
addres    -  address
addy    -  address
admin    -  administrator
afta    -  after
aftr    -  after
agen    -  agent
aht    -  out
aight    -  alright
aite    -  alright
akward    -  awkward
alll    -  all
allll    -  all
alllll    -  all
allllll    -  all
alrdy    -  already
alrighty    -  alright
alrite    -  alright
altho    -  although
alway    -  always
alwayz    -  always
amazin    -  amazing
amazingg    -  amazing
amazinggg    -  amazing
andd    -  and
anniv    -  anniversary
annoyin    -  annoying
anotha    -  another
anutha    -  another
any1    -  anyone
anythin    -  anything
anywho    -  anyhow
approx    -  approximately
appt    -  appointment
aqain    -  again
aree    -  are
arnd    -  around
arnt    -  aren't
arse    -  ass
askd    -  asked
askin    -  asking
assoc    -  association
asss    -  ass
attn    -  attention
auf    -  of
avg    -  average
aweful    -  awful
awesomee    -  awesome
awsome    -  awesome
azz    -  ass
b'day    -  birthday
b4    -  before
baaad    -  bad
baaby    -  baby
babee    -  babe
babez    -  babes
babi    -  baby
babyy    -  baby
babyyy    -  baby
bac    -  back
bacc    -  back
backk    -  back
backround    -  background
badd    -  bad
baddd    -  bad
bak    -  back
bakk    -  back
ballin    -  balling
bangin    -  banging
baq    -  back
basterds    -  bastards
baybee    -  baby
bb    -  baby
bbq    -  barbeque
bbs    -  blackberries
bby    -  baby
bc    -  because
bck    -  back
bcoz    -  because
bcuz    -  because
bday    -  birthday
be4    -  before
beatin    -  beating
beatz    -  beats
beautifull    -  beautiful
becuase    -  because
becuz    -  because
bee    -  be
befor    -  before
beggin    -  begging
beh    -  be
bein    -  being
beleive    -  believe
belieber    -  believer
beliebers    -  believers
belive    -  believe
betch    -  bitch
beter    -  better
betta    -  better
bfast    -  breakfast
biatch    -  bitch
bich    -  bitch
biebers    -  bieber's
bigg    -  big
biotch    -  bitch
birthdayy    -  birthday
bitchez    -  bitches
bitchh    -  bitch
bitchin    -  bitching
bitt    -  bit
biz    -  business
bizness    -  business
bk    -  back
bkk    -  back
bkuz    -  because
blankie    -  blanket
blastin    -  blasting
bldg    -  building
blk    -  bulk
bln    -  billion
blowin    -  blowing
bod    -  body
boi    -  boy
boii    -  boy
boobie    -  booby
boredd    -  bored
boreddd    -  bored
bots    -  boots
bout    -  about
boyy    -  boy
breakin    -  breaking
brib    -  crib
bringin    -  bringing
bro    -  brother
broo    -  brother
bros    -  brothers
brotha    -  brother
bru    -  brother
brutha    -  brother
bruv    -  brave
bs    -  bullshit
bt    -  but
btwn    -  between
buble    -  bubble
buggin    -  bugging
buh    -  but
buhh    -  but
buht    -  but
buildin    -  building
buisness    -  business
bumpin    -  bumping
burnin    -  burning
buyin    -  buying
buzzin    -  buzzing
bx    -  box
bxtch    -  bitch
byee    -  bye
byeee    -  bye
byeeee    -  bye
bytch    -  bitch
cack    -  back
calender    -  calendar
callin    -  calling
cams    -  cameras
capt    -  captain
carb    -  carbohydrates
carbs    -  carbohydrates
caree    -  care
catchin    -  catching
cause    -  because
celeb    -  celebrity
celly    -  cell
cept    -  except
cert    -  certain
changin    -  changing
chargin    -  charging
cheatin    -  cheating
checkd    -  checked
checkin    -  checking
chics    -  chicks
chik    -  chick
chillen    -  chilling
chilli    -  chili
chillin    -  chilling
chilln    -  chilling
chk    -  check
choc    -  chocolate
choco    -  chocolate
choos    -  choose
chrismas    -  christmas
christmass    -  christmas
christmassy    -  christmas
chu    -  you
cig    -  cigarette
cigs    -  cigarettes
cit    -  city
ckck    -  cock
cking    -  cooking
cl    -  clear
cld    -  could
cleanin    -  cleaning
clit    -  clitoris
clubbin    -  clubbing
cme    -  come
cmt    -  comment
cn    -  can
cnt    -  can't
coffe    -  coffee
col    -  cold
comee    -  come
comin    -  coming
commin    -  coming
comming    -  coming
comn    -  coming
completly    -  completely
conf    -  conference
congratz    -  congratulations
congrats   -   congratulations
conv    -  conversion
convo    -  conversation
convos    -  conversation
coo    -  cool
cookin    -  cooking
coolin    -  cooling
coool    -  cool
cooool    -  cool
coppin    -  copping
corp    -  corporation
cos    -  because
cosign    -  consign
couldn    -  couldn't
couldnt    -  couldn't
countin    -  counting
coz    -  because
cps    -  copies
cpt    -  except
cr8te    -  create
crackin    -  cracking
crazyy    -  crazy
crazyyy    -  crazy
crimbo    -  christmas
cryin    -  crying
cud    -  could
cudnt    -  couldn't
cuffin    -  cuffing
cuhz    -  because
culd    -  could
cum    -  come
cummin    -  common
cums    -  comes
cus    -  because
cutee    -  cute
cuteee    -  cute
cutt    -  cut
cuttin    -  cutting
cuzin    -  cousin
cuzo    -  cousin
cuzzin    -  cousin
daddys    -  daddy's
dah    -  the
dai    -  day
dammm    -  damn
damnn    -  damn
damnnn    -  damn
damnnnn    -  damn
dancin    -  dancing
dat    -  that
dats    -  that's
datt    -  that
dayum    -  damn
dayy    -  day
dayyy    -  day
dayz    -  days
ddnt    -  didn't
dealin    -  dealing
dec    -  december
dee    -  the
deez    -  these
deff    -  definitely
deffo    -  definitely
definately    -  definitely
definatly    -  definitely
definetly    -  definitely
definitly    -  definitely
defo    -  definitely
deg    -  degree
dennys    -  denny's
dept    -  department
dere    -  there
deres    -  there's
des    -  these
desconecte    -  disconnect
dese    -  these
dha    -  the
dhat    -  that
dhis    -  this
didnt    -  didn't
diff    -  different
diffrent    -  different
diggin    -  digging
dint    -  didn't
dis    -  this
dissapointed    -  disappointed
dissapointing    -  disappointing
diz    -  this
dl    -  download
dne    -  done
dnt    -  don't
doc    -  doctor
docs    -  doctors
dodgy    -  dodge
doen    -  done
doesn    -  doesn't
doesnt    -  doesn't
doiin    -  doing
doin    -  doing
doinq    -  doing
dolla    -  dollar
don    -  don't
dont    -  don't
dood    -  dude
dooo    -  do
doooo    -  do
dosent    -  doesn't
dreamin    -  dreaming
drinkin    -  drinking
drivin    -  driving
drm    -  dream
droppin    -  dropping
drt    -  dirt
duit    -  suit
dun    -  don't
dunt    -  don't
durin    -  during
duvet    -  duet
dwn    -  down
dyin    -  dying
eatin    -  eating
eatinq    -  eating
eatn    -  eaten
eatting    -  eating
ecademy    -  academy
ect    -  etc
effin    -  fucking
effing    -  fucking
ehem    -  them
ello    -  hello
em    -  them
embarassed    -  embarrassed
enjoyin    -  enjoying
enuf    -  enough
enuff    -  enough
ep    -  episode
epi    -  episode
eps    -  episode
errbody    -  everybody
ev    -  even
eva    -  ever
evar    -  ever
everbody    -  everybody
everr    -  ever
everrr    -  ever
everthing    -  everything
every1    -  everyone
everyonee    -  everyone
everythin    -  everything
evn    -  even
evr    -  ever
evry    -  every
evrybody    -  everybody
evryone    -  everyone
evrything    -  everything
exp    -  experience
ext    -  extension
ez    -  easy
f'n    -  fucking
fa    -  for
fab    -  fabulous
fabolous    -  fabulous
fakkk    -  fuck
fav    -  favorite
fave    -  favorite
faves    -  favorites
favs    -  favorites
fb    -  facebook
fck    -  fuck
fckin    -  fucking
fcking    -  fucking
fckn    -  fucking
fcuk    -  fuck
feb    -  february
feeel    -  feel
feelin    -  feeling
feelins    -  feelings
feeln    -  feeling
ffb    -  facebook
ffffound    -  found
fic    -  fix
fightin    -  fighting
finaly    -  finally
fixin    -  fixing
fk    -  fuck
fkn    -  fucking
fla    -  florida
flocka    -  flock
flyin    -  flying
fmly    -  family
fo    -  for
folllow    -  follow
followin    -  following
followw    -  follow
follwers    -  followers
fone    -  phone
forr    -  for
fr    -  for
fre    -  free
freakin    -  freaking
freezin    -  freezing
freinds    -  friends
fren    -  friend
fri    -  friday
frickin    -  freaking
friendss    -  friends
friggen    -  freaking
friggin    -  freaking
frm    -  from
frnd    -  friend
frnds    -  friends
frontin    -  fronting
frumm    -  from
fuc    -  fuck
fucc    -  fuck
fuccin    -  fucking
fucka    -  fucker
fucken    -  fucking
fuckin    -  fucking
fuckk    -  fuck
fuckkk    -  fuck
fuckn    -  fucking
fugly    -  ugly
fuk    -  fuck
fukin    -  fucking
fukk    -  fuck
fukkin    -  fucking
fukn    -  fucking
funn    -  fun
funni    -  funny
fuq    -  fuck
fux    -  fuck
fwd    -  forward
fxck    -  fuck
g0    -  go
gaat    -  got
gasc    -  gas
gawd    -  god
gayyy    -  gay
gd    -  good
getin    -  getting
geting    -  getting
getn    -  getting
gett    -  get
gettin    -  getting
gettn    -  getting
gf    -  girlfriend
girlies    -  girls
girll    -  girl
girly    -  girls
girlz    -  girls
git    -  get
giv    -  give
givin    -  giving
gn    -  going
gne    -  gone
gng    -  going
goiin    -  going
goin    -  going
goingg    -  going
goo    -  go
goog    -  good
gooo    -  go
goood    -  good
gooood    -  good
gooooo    -  go
goooood    -  good
goooooo    -  go
gooooood    -  good
goooooood    -  good
gots    -  got
gov    -  government
gov't    -  government
govt    -  government
gr8    -  great
greatful    -  grateful
grindin    -  grinding
grl    -  girl
growin    -  growing
grt    -  great
gt    -  get
gud    -  good
gudd    -  good
gurl    -  girl
gurls    -  girls
guud    -  good
guyss    -  guys
guyz    -  guys
gv    -  give
gyal    -  girl
h0me    -  home
h8    -  hate
habbo    -  hobby
hangin    -  hanging
happend    -  happened
happenin    -  happening
happpy    -  happy
hasnt    -  hasn't
haterz    -  haters
hatin    -  hating
hav    -  have
havee    -  have
havent    -  haven't
havin    -  having
havn    -  having
havn't    -  haven't
havnt    -  haven't
hawt    -  hot
haz    -  has
hea    -  head
headin    -  heading
heeeeey    -  hey
heeeey    -  hey
heeey    -  hey
heey    -  hey
hei    -  he
hellooo    -  hello
helloooo    -  hello
hellz    -  hell
helpin    -  helping
heree    -  here
heres    -  here's
hes    -  he's
heyy    -  hey
heyyy    -  hey
heyyyy    -  hey
hiam    -  him
hid    -  hide
hii    -  hi
hiiii    -  hi
hillarious    -  hilarious
himm    -  him
hittin    -  hitting
hld    -  hold
hme    -  home
hol    -  holiday
holdin    -  holding
hols    -  holidays
homee    -  home
homeee    -  home
homeworkk    -  homework
hommie    -  home
hoow    -  how
hopin    -  hoping
hoppin    -  hopping
hos    -  has
hosp    -  hospital
hottt    -  hot
housee    -  house
hows    -  how's
hr    -  hour
hrs    -  hours
htt    -  hot
hubby    -  husband
humax    -  human
hunni    -  honey
hunnie    -  honey
hunny    -  honey
hurr    -  hair
hv    -  have
hve    -  have
hw    -  how
hwy    -  highway
hyoomans    -  humans
id    -  i'd
ight    -  alright
iht    -  it
ii    -  i
iif    -  if
iight    -  light
iin    -  in
iis    -  is
iit    -  it
iits    -  its
ill    -  i'll
illest    -  list
illuminati    -  illuminate
img    -  image
incl    -  including
ind    -  india
insanely    -  instantly
int    -  international
int'l    -  international
internets    -  internet
intl    -  international
intresting    -  interesting
intro    -  introduction
isn    -  isn't
isnt    -  isn't
iss    -  is
isz    -  is
ite    -  it
itss    -  its
itt    -  it
ittt    -  it
itttt    -  it
itz    -  it's
iz    -  is
jammin    -  jamming
jeeze    -  jesus
jelous    -  jealous
jerkin    -  jerking
jokin    -  joking
js    -  just
jst    -  just
jsut    -  just
jumpin    -  jumping
jus    -  just
juss    -  just
justins    -  justin's
juz    -  just
jz    -  just
k    -  ok
kan    -  can
kant    -  can't
kasih    -  kiss
keepin    -  keeping
kewl    -  cool
kickin    -  kicking
kidddddd    -  kid
kiddin    -  kidding
kiddo    -  kid
kiddos    -  kids
kidz    -  kids
killa    -  killer
killin    -  killing
kissin    -  kissing
kmt    -  commit
kno    -  know
knockin    -  knocking
knoe    -  know
knoo    -  know
knowin    -  knowing
knoww    -  know
knowww    -  know
knw    -  know
knwo    -  know
konvict    -  convict
kool    -  cool
koolaid    -  cooled
krazy    -  crazy
kum    -  come
kuz    -  because
l8r    -  later
lappy    -  laptop
laterr    -  later
laughin    -  laughing
lawd    -  lord
layin    -  laying
leavin    -  leaving
legos    -  legs
lettin    -  letting
liek    -  like
lifee    -  life
liike    -  like
lik    -  like
likeee    -  like
likey    -  likely
likin    -  liking
lil    -  little
linkin    -  linking
listenin    -  listening
livin    -  living
lk    -  like
lke    -  like
ll    -  will
lng    -  long
loa    -  low
loc    -  local
lockerz    -  lockers
lookin    -  looking
lookn    -  looking
looong    -  long
loooong    -  long
looooove    -  love
loooove    -  love
looove    -  love
loosin    -  loosing
loove    -  love
losin    -  losing
lov    -  love
lovee    -  love
loveee    -  love
loveeee    -  love
loveeeee    -  love
lovey    -  love
lovin    -  loving
luh    -  love
luv    -  love
luvin    -  loving
luvv    -  love
lv    -  love
lvl    -  level
lvls    -  levels
lyfe    -  life
lyin    -  lying
lyk    -  like
m    -  am
ma    -  my
ma'am    -  madam
maaaan    -  man
maaan    -  man
maan    -  man
macam    -  madam
madd    -  mad
maddd    -  mad
mah    -  my
maken    -  make
makin    -  making
mann    -  man
mannn    -  man
mannnn    -  man
matress    -  mattress
max    -  maximum
mayb    -  maybe
mayne    -  man
mazing    -  amazing
meanie    -  mean
meds    -  medicines
mee    -  me
meee    -  me
meeee    -  me
meeeee    -  me
meeh    -  me
meetin    -  meeting
meh    -  me
mem    -  member
memba    -  remember
menggila    -  mingle
ment    -  meant
merecal    -  miracle
messin    -  messing
messs    -  mess
mgmt    -  management
mgr    -  manager
mha    -  my
mi    -  my
midnite    -  midnight
mii    -  my
millz    -  mills
min    -  minutes
mines    -  mine
mins    -  minutes
minum    -  minimum
misc    -  miss
missin    -  missing
misss    -  miss
mite    -  might
mixx    -  mix
mk    -  make
mkay    -  okay
mke    -  make
mkt    -  market
mlb    -  major league baseball
mln    -  million
mo    -  more
mobb    -  mob
mobbin    -  mobbing
mods    -  modifications
momz    -  mom
mon    -  monday
moore    -  more
morn    -  morning
mornin    -  morning
morningg    -  morning
motha    -  mother
mouf    -  mouth
mousse    -  mouse
mov    -  move
movember    -  november
moviee    -  movie
movin    -  moving
mre    -  more
msft    -  microsoft
msg    -  message
msgs    -  messages
mtg    -  meeting
muchh    -  much
muh    -  my
mus    -  must
musik    -  music
musiq    -  music
mutha    -  mother
mv    -  movie
mwah    -  kiss
mye    -  my
myy    -  my
mz    -  ms
n2    -  into
naah    -  no
nahh    -  no
nat'l    -  national
naww    -  no
nd    -  and
ne    -  new
neeed    -  need
nething    -  nothing
neue    -  new
neva    -  never
nevr    -  never
neway    -  anyway
neww    -  new
newz    -  news
nicee    -  nice
niceee    -  nice
niceeee    -  nice
niggaz    -  niggers
nigguh    -  nigger
nightt    -  night
niice    -  nice
niiice    -  nice
niqqas    -  niggers
nite    -  night
nites    -  nights
nme    -  name
noe    -  know
noms    -  nominations
noo    -  no
nooo    -  no
noooo    -  no
nooooo    -  no
noooooo    -  no
nooooooo    -  no
noooooooo    -  no
nooooooooo    -  no
nothin    -  nothing
nothinq    -  nothing
nothn    -  nothing
notttt    -  not
nov    -  november
noww    -  now
nowww    -  now
nowwww    -  now
nsync    -  nosing
nt    -  not
nu    -  new
nuff    -  enough
nuffin    -  nothing
num    -  number
numba    -  number
nuthin    -  nothing
nuthn    -  nothing
nuttin    -  nothing
nutz    -  nuts
nvr    -  never
nw    -  now
nws    -  news
nxt    -  next
nyt    -  night
oakay    -  okay
obv    -  obviously
offf    -  off
offically    -  officially
og    -  of
ohh    -  oh
ohhhh    -  oh
ohhhhhh    -  oh
ohkay    -  okay
okaay    -  okay
okayy    -  okay
okayyy    -  okay
oke    -  ok
okk    -  ok
okkk    -  ok
onee    -  one
onli    -  only
onn    -  on
onnn    -  on
ont    -  don't
oohhh    -  oh
oooh    -  oh
ooohh    -  oh
ooohhh    -  oh
ooooooh    -  oh
oovoo    -  obviously
ops    -  operations
org    -  organization
otha    -  other
outt    -  out
outtie    -  out
outtt    -  out
ov    -  of
ova    -  over
ove    -  over
ovr    -  over
owt    -  anything
packin    -  packing
panto    -  pants
partay    -  party
partna    -  partner
partyin    -  partying
partys    -  parties
partyy    -  party
passin    -  passing
pawpawty    -  puppet
payed    -  paid
payin    -  paying
pct    -  picture
pd    -  paid
pedi    -  pedicure
peeps    -  people
peope    -  people
perfecto    -  perfect
performin    -  performing
perm    -  permanent
perv    -  pervert
phat    -  fat
phonee    -  phone
photog    -  photographer
phx    -  phoenix
pic    -  picture
pickin    -  picking
pics    -  pictures
piff    -  puff
pilates    -  pirates
pissin    -  pissing
pix    -  pictures
pl    -  people
plannin    -  planning
playa    -  play
playin    -  playing
playn    -  playing
pleas    -  please
pleasee    -  please
pleaseee    -  please
pleaseeee    -  please
pleaseeeee    -  please
pleeease    -  please
pleeeeease    -  please
pleez    -  please
pls    -  please
plz    -  please
plzx    -  please
plzz    -  please
plzzz    -  please
plzzzz    -  please
poppin    -  popping
ppl    -  people
pple    -  people
ppls    -  people's
pplz    -  people's
prayin    -  praying
preciate    -  appreciate
preggo    -  pregnant
pres    -  press
pressies    -  presents
prez    -  president
prob    -  probably
probly    -  probably
prof    -  professional
prog    -  program
prolly    -  probably
prov    -  prove
pt    -  part
pts    -  points
pumpin    -  pumping
pushin    -  pushing
putt    -  put
puttin    -  putting
pw    -  password
pwned    -  owned
qet    -  get
qik    -  quick
qirl    -  girl
qld    -  queensland
qo    -  go
qoin    -  going
qoinq    -  going
qood    -  good
qot    -  got
qtr    -  quarter
rainin    -  raining
rappin    -  rapping
rarr    -  rare
rd    -  road
rdy    -  ready
re    -  regarding
readin    -  reading
readyy    -  ready
realli    -  really
realy    -  really
recieve    -  receive
recomend    -  recommend
rediculous    -  ridiculous
relaxin    -  relaxing
rele    -  really
remeber    -  remember
repl    -  reply
reppin    -  repping
req    -  request
retarted    -  retarded
ridic    -  ridiculous
ridin    -  riding
righ    -  right
rightt    -  right
ringin    -  ringing
rite    -  right
ritee    -  right
rl    -  real
rlly    -  really
rly    -  really
rm    -  room
rockin    -  rocking
rong    -  wrong
roomie    -  room
roomies    -  roommates
rsa    -  russia
rting    -  writing
rts    -  retweets
rubbin    -  rubbing
rugrats    -  regrets
rulez    -  rules
runnin    -  running
ryt    -  right
ryte    -  right
sadd    -  sad
samee    -  same
sammich    -  sandwich
sandwhich    -  sandwich
sayin    -  saying
sayn    -  saying
sayy    -  say
sbux    -  starbucks
sch    -  school
schoool    -  school
schooool    -  school
sci    -  science
scifi    -  scientific
screamin    -  screaming
sec    -  second
secs    -  seconds
sed    -  said
seee    -  see
seein    -  seeing
seh    -  say
sekali    -  scale
sekurity    -  security
sellin    -  selling
sence    -  sense
sendin    -  sending
seperate    -  separate
serie    -  series
serv    -  service
ses    -  uses
sesh    -  session
sexi    -  sexy
sez    -  says
sh    -  shit
shakin    -  shaking
shat    -  shit
shd    -  should
shee    -  she
sheeesh    -  sheesh
shes    -  she's
shhh    -  she
shid    -  shit
shii    -  shit
shiiit    -  shit
shinin    -  shining
shite    -  shit
shitt    -  shit
shittt    -  shit
shiz    -  shit
shizz    -  shit
shld    -  should
shootin    -  shooting
shoppin    -  shopping
shouldnt    -  shouldn't
showcse    -  showcase
showin    -  showing
sht    -  shit
shud    -  should
shuld    -  should
shxt    -  shit
shyt    -  shit
sickk    -  sick
singin    -  singing
sippin    -  sipping
sis    -  sister
sist    -  sister
sista    -  sister
sittin    -  sitting
ska    -  skate
skewl    -  school
skillz    -  skills
skoo    -  school
skool    -  school
skul    -  school
slackin    -  slacking
slappin    -  slapping
sleeeep    -  sleep
sleeep    -  sleep
sleepin    -  sleeping
slippin    -  slipping
slo    -  slow
slp    -  sleep
sm    -  some
sme    -  some
smellin    -  smelling
smoothie    -  smooth
smoove    -  smooth
smth    -  something
snd    -  send
snowin    -  snowing
som    -  some
some1    -  someone
somee    -  some
someones    -  someone's
somethin    -  something
somethinggg    -  something
somone    -  someone
somthin    -  something
somthing    -  something
songz    -  songs
soo    -  so
sooo    -  so
sooon    -  soon
soooo    -  so
sooooo    -  so
soooooo    -  so
sooooooo    -  so
soooooooo    -  so
sooooooooo    -  so
soooooooooo    -  so
sooooooooooo    -  so
soooooooooooo    -  so
soz    -  sorry
speakin    -  speaking
spendin    -  spending
spinnin    -  spinning
spittin    -  spitting
sq    -  square
srry    -  sorry
srsly    -  seriously
sry    -  sorry
standin    -  standing
starring    -  staring
startin    -  starting
starvin    -  starving
statuses    -  status
stayin    -  staying
stealin    -  stealing
steppin    -  stepping
sth    -  something
stickin    -  sticking
stil    -  still
stinkin    -  stinking
stoopid    -  stupid
stoppin    -  stopping
stp    -  stop
str8    -  straight
stressin    -  stressing
studyin    -  studying
stuntin    -  stunting
sucka    -  suck
suckin    -  sucking
sum    -  some
sum1    -  someone
sumbody    -  somebody
sumn    -  something
sumone    -  someone
sumthin    -  something
sumthing    -  something
sumthn    -  something
sumtimes    -  sometimes
sumtin    -  something
sumwhere    -  somewhere
sup    -  super
supa    -  super
suposed    -  supposed
suprise    -  surprise
suree    -  sure
suttin    -  something
sux    -  sucks
svc    -  service
sweeeet    -  sweet
sweeet    -  sweet
syg    -  saying
sz    -  size
ta    -  to
takin    -  taking
talkin    -  talking
talkn    -  talking
tat    -  that
tats    -  that's
tatt    -  tattoo
tatts    -  tattoos
tday    -  today
technolo    -  technology
teh    -  the
tekken    -  taken
tel    -  tell
tellin    -  telling
telln    -  telling
tew    -  to
textin    -  texting
textt    -  text
texxt    -  text
th    -  the
tha    -  the
thaa    -  the
thang    -  thing
thangs    -  things
thankies    -  thanks
thankss    -  thanks
thanksss    -  thanks
thankx    -  thanks
thankz    -  thanks
thanx    -  thanks
thanxx    -  thanks
thas    -  that's
thats    -  that's
thatt    -  that
thatz    -  that's
themm    -  them
thenn    -  then
ther    -  there
theyre    -  they're
thiis    -  this
thinkin    -  thinking
thinkk    -  think
thinkn    -  thinking
thiss    -  this
thiz    -  this
thk    -  think
thks    -  thanks
thm    -  them
thn    -  then
thng    -  thing
thnks    -  thanks
thnx    -  thanks
tho    -  though
thongs    -  things
thoo    -  though
thot    -  thought
thou    -  though
thouu    -  though
thr    -  there
thro    -  throw
throwin    -  throwing
thru    -  through
ths    -  this
tht    -  that
thts    -  that's
thu    -  thursday
thurs    -  thursday
thx    -  thanks
tierd    -  tired
timeee    -  time
tings    -  things
tiredd    -  tired
tite    -  tight
tix    -  ticket
tk    -  take
tks    -  thanks
tld    -  told
tlk    -  talk
tlkin    -  talking
tlkn    -  talking
tmo    -  tomorrow
tmr    -  tomorrow
tmrw    -  tomorrow
tmw    -  tomorrow
tnx    -  thanks
todas    -  todays
todayy    -  today
tomarrow    -  tomorrow
tommorow    -  tomorrow
tommorrow    -  tomorrow
tomo    -  tomorrow
tomoro    -  tomorrow
tomorro    -  tomorrow
tomoz    -  tomorrow
tonights    -  tonight's
tonightt    -  tonight
tonite    -  tonight
tooo    -  too
toooo    -  too
tooooo    -  too
toooooo    -  too
tooooooo    -  too
totaly    -  totally
tr    -  try
tra    -  try
treatin    -  treating
trickin    -  tricking
trippin    -  tripping
tru    -  true
truee    -  true
truely    -  truly
tryed    -  tried
tryin    -  trying
tryingg    -  trying
tryn    -  trying
tts    -  that's
tue    -  tuesday
tues    -  tuesday
tuff    -  tough
turnin    -  turning
tv    -  television
twat    -  that
tweetin    -  tweeting
tweetn    -  tweeting
twic    -  twice
twiiter    -  twitter
twiter    -  twitter
twits    -  tweets
twitta    -  twitter
twttr    -  twitter
tx    -  texas
txt    -  text
txtin    -  texting
txting    -  texting
txtn    -  texting
txts    -  texts
tym    -  time
tyme    -  time
u    -  you
u'r    -  your
ugggh    -  ugh
uhp    -  up
und    -  and
undead    -  unread
uni    -  university
univ    -  university
upp    -  up
uppp    -  up
upppp    -  up
ur    -  your
urs    -  yours
urself    -  yourself
usin    -  using
ustream    -  upstream
utd    -  united
utube    -  youtube
uu    -  you
uur    -  your
uuu    -  you
uuuu    -  you
vag    -  vagina
veg    -  vegetarian
versi    -  version
vid    -  video
vids    -  videos
vocab    -  vocabulary
vry    -  very
vtg    -  vintage
wa    -  was
waaaay    -  way
waaay    -  way
waht    -  what
waitin    -  waiting
waitn    -  waiting
wakin    -  waking
walkin    -  walking
wantin    -  wanting
wantt    -  want
wasn    -  wasn't
wasnt    -  wasn't
wat    -  what
watchin    -  watching
watchinq    -  watching
watchn    -  watching
wateva    -  whatever
watever    -  whatever
wats    -  what's
wayy    -  way
wayyy    -  way
wayyyy    -  way
waz    -  was
wearin    -  wearing
weee    -  we
wel    -  well
welll    -  well
wen    -  when
wer    -  were
werent    -  weren't
werk    -  work
wha    -  what
whaaat    -  what
whaat    -  what
whatev    -  whatever
whateva    -  whatever
whatevs    -  whatever
whatt    -  what
whattt    -  what
whatz    -  what is
whens    -  when's
wher    -  where
whn    -  when
whoaa    -  who
whoopin    -  whooping
whr    -  where
wht    -  what
whts    -  what's
whut    -  what
whyy    -  why
whyyy    -  why
whyyyy    -  why
wid    -  with
widd    -  with
wierd    -  weird
wif    -  with
wiff    -  with
wil    -  will
wildin    -  wilding
willl    -  will
winnin    -  winning
wishin    -  wishing
wit    -  with
withh    -  with
witout    -  without
wiv    -  with
wk    -  week
wkend    -  weekend
wknd    -  weekend
wks    -  weeks
wl    -  will
wld    -  would
wnt    -  want
wnts    -  wants
womans    -  woman's
wonderfull    -  wonderful
wonderin    -  wondering
wooot    -  what
wordd    -  world
workin    -  working
workk    -  work
workn    -  working
wot    -  what
wouldn    -  would
wouldnt    -  wouldn't
woww    -  wow
wowww    -  wow
wr    -  were
wrd    -  word
writin    -  writing
writting    -  writing
wrk    -  work
ws    -  was
wt    -  what
wud    -  would
wudnt    -  wouldn't
wuld    -  would
wun    -  won't
wus    -  was
wut    -  what
wuz    -  was
x'mas    -  christmas
xmas    -  christmas
xmass    -  christmas
xtra    -  extra
yaaay    -  yay
yahh    -  yeah
yaself    -  yourself
yayyyy    -  way
yayyyyy    -  yay
yds    -  yards
yea    -  yeah
yeaa    -  yes
yeaaa    -  yeah
yeaaaa    -  yeah
yeaaah    -  yeah
yeahh    -  yeah
yeahhh    -  yeah
yeahhhh    -  yeah
yeahhhhh    -  yeah
yeeah    -  yeah
yehh    -  yeah
yer    -  your
yess    -  yes
yesss    -  yes
yessss    -  yes
yesssss    -  yes
yessssss    -  yes
yesssssss    -  yes
yessssssss    -  yes
yhu    -  you
yo    -  you
yoo    -  you
yooo    -  you
yoooo    -  you
yoou    -  you
yor    -  you
yoself    -  yourself
youd    -  you'd
youh    -  you
youll    -  you'll
yous    -  you
youu    -  you
youuu    -  you
youuuu    -  you
youuuuu    -  you
youuuuuu    -  you
ypu    -  you
yr    -  year
yrs    -  years
yt    -  yet
yu    -  you
yuhh    -  you
yumm    -  yummy
yummm    -  yummy
yummmm    -  yum
yummmy    -  yummy
yupp    -  yes
yuppp    -  yes
yur    -  your
yuu    -  you
yuup    -  yes
yy    -  year